Gender,forearm center of grip length,elbow wrist length,hand breadth,hand circumference,thumbbreadth estimated,radial estylion length,wrist circumference,forearm circumference flexed,forearm taper diff
Female,290,530,77,182,21٫56,221,146,252,106
Female,290,538,76,183,21٫28,220,147,262,115
Female,290,542,77,186,21٫56,221,155,270,115
Female,290,544,75,181,21,228,159,277,118
Female,290,545,80,191,22٫4,222,154,247,93
Female,290,546,76,184,21٫28,228,158,266,108
Female,290,553,79,192,22٫12,229,154,278,124
Female,291,529,73,187,20٫44,219,151,257,106
Female,291,535,72,175,20٫16,229,143,248,105
Female,291,535,82,196,22٫96,220,156,273,117
Female,291,536,74,174,20٫72,225,143,235,92
Female,291,542,75,175,21,228,157,284,127
Female,291,543,75,177,21,226,145,256,111
Female,291,544,78,188,21٫84,223,151,252,101
Female,292,531,74,180,20٫72,228,145,262,117
Female,292,533,74,175,20٫72,225,146,267,121
Female,292,534,78,187,21٫84,223,156,268,112
Female,292,542,75,186,21,220,154,264,110
Female,292,548,77,181,21٫56,224,152,259,107
Female,293,528,75,180,21,222,144,249,105
Female,293,542,75,177,21,220,150,254,104
Female,293,548,80,189,22٫4,226,146,256,110
Female,293,550,79,189,22٫12,224,156,257,101
Female,293,550,79,193,22٫12,226,157,261,104
Female,294,530,80,196,22٫4,226,156,275,119
Female,294,532,78,188,21٫84,220,144,242,98
Female,294,536,78,188,21٫84,223,150,246,96
Female,294,537,80,191,22٫4,222,158,257,99
Female,294,537,81,192,22٫68,221,154,270,116
Female,294,540,78,190,21٫84,224,156,283,127
Female,294,544,80,189,22٫4,222,146,250,104
Female,294,548,77,188,21٫56,227,152,255,103
Female,294,549,78,190,21٫84,227,150,264,114
Female,294,550,80,190,22٫4,222,159,268,109
Female,294,551,76,180,21٫28,220,158,276,118
Female,294,570,76,183,21٫28,238,143,245,102
Female,295,530,81,188,22٫68,226,154,257,103
Female,295,533,77,185,21٫56,221,150,256,106
Female,295,534,73,177,20٫44,219,150,250,100
Female,295,541,78,180,21٫84,229,148,240,92
Female,295,546,73,178,20٫44,228,154,267,113
Female,295,549,76,176,21٫28,232,145,238,93
Female,295,552,78,185,21٫84,229,156,246,90
Female,295,553,80,180,22٫4,232,149,250,101
Female,295,558,77,186,21٫56,228,152,246,94
Female,295,558,80,187,22٫4,227,151,251,100
Female,295,563,75,179,21,232,147,262,115
Female,295,566,74,186,20٫72,222,154,271,117
Female,296,531,72,173,20٫16,224,145,249,104
Female,296,534,74,176,20٫72,228,153,253,100
Female,296,536,75,187,21,222,154,286,132
Female,296,536,76,182,21٫28,219,153,249,96
Female,296,537,78,182,21٫84,224,149,275,126
Female,296,540,80,190,22٫4,226,152,249,97
Female,296,542,83,196,23٫24,232,154,273,119
Female,296,543,75,185,21,229,143,242,99
Female,296,544,73,173,20٫44,226,150,252,102
Female,296,544,75,177,21,222,147,238,91
Female,296,548,74,175,20٫72,229,152,258,106
Female,296,551,76,181,21٫28,232,146,247,101
Female,296,551,81,190,22٫68,226,153,280,127
Female,296,554,74,177,20٫72,228,154,257,103
Female,296,554,77,179,21٫56,232,147,242,95
Female,296,554,78,189,21٫84,231,151,272,121
Female,296,555,72,174,20٫16,233,145,239,94
Female,296,556,75,177,21,225,155,257,102
Female,296,557,80,188,22٫4,218,157,250,93
Female,296,558,76,177,21٫28,229,154,278,124
Female,296,569,80,187,22٫4,236,150,256,106
Female,296,570,75,183,21,237,148,255,107
Female,297,529,76,179,21٫28,230,159,260,101
Female,297,530,78,182,21٫84,222,154,255,101
Female,297,536,77,178,21٫56,221,146,245,99
Female,297,537,78,192,21٫84,218,155,244,89
Female,297,549,78,182,21٫84,235,145,237,92
Female,297,556,76,179,21٫28,223,145,255,110
Female,297,558,73,177,20٫44,225,153,249,96
Female,297,559,77,187,21٫56,228,151,258,107
Female,297,560,77,177,21٫56,232,158,257,99
Female,297,564,74,188,20٫72,226,154,253,99
Female,297,570,81,192,22٫68,227,161,280,119
Female,298,531,78,185,21٫84,219,147,252,105
Female,298,532,76,179,21٫28,222,146,260,114
Female,298,533,76,178,21٫28,222,146,238,92
Female,298,540,77,180,21٫56,230,150,263,113
Female,298,540,77,183,21٫56,235,156,276,120
Female,298,541,72,177,20٫16,231,144,245,101
Female,298,544,77,179,21٫56,229,148,253,105
Female,298,545,76,183,21٫28,232,153,245,92
Female,298,546,78,186,21٫84,223,154,261,107
Female,298,549,84,195,23٫52,231,154,254,100
Female,298,552,77,179,21٫56,228,159,261,102
Female,298,553,75,180,21,228,154,260,106
Female,298,556,75,177,21,232,158,278,120
Female,298,562,77,179,21٫56,229,147,260,113
Female,298,563,78,183,21٫84,223,163,278,115
Female,298,564,80,189,22٫4,232,158,257,99
Female,298,573,77,183,21٫56,239,149,251,102
Female,298,574,77,180,21٫56,240,145,246,101
Female,299,537,76,179,21٫28,222,152,249,97
Female,299,542,79,184,22٫12,227,151,254,103
Female,299,546,78,189,21٫84,222,154,272,118
Female,299,549,79,187,22٫12,230,147,263,116
Female,299,549,80,194,22٫4,238,161,272,111
Female,299,558,75,180,21,231,144,248,104
Female,299,567,78,185,21٫84,235,153,270,117
Female,299,576,77,187,21٫56,235,155,263,108
Female,299,581,80,190,22٫4,233,152,250,98
Female,300,533,82,192,22٫96,222,155,258,103
Female,300,534,77,185,21٫56,218,152,265,113
Female,300,542,74,179,20٫72,235,144,250,106
Female,300,542,75,178,21,223,153,248,95
Female,300,542,77,192,21٫56,221,160,261,101
Female,300,542,81,193,22٫68,228,152,253,101
Female,300,543,75,181,21,223,158,275,117
Female,300,546,74,183,20٫72,232,147,250,103
Female,300,546,77,180,21٫56,221,147,246,99
Female,300,548,72,174,20٫16,226,148,261,113
Female,300,550,76,177,21٫28,224,152,252,100
Female,300,553,77,180,21٫56,234,146,260,114
Female,300,553,79,189,22٫12,229,154,249,95
Female,300,555,72,173,20٫16,231,145,254,109
Female,300,555,75,183,21,219,147,254,107
Female,300,556,76,190,21٫28,232,150,255,105
Female,300,561,76,179,21٫28,229,148,282,134
Female,300,561,79,183,22٫12,233,157,260,103
Female,300,562,76,182,21٫28,238,147,268,121
Female,300,578,75,178,21,233,151,272,121
Female,301,532,76,182,21٫28,225,153,267,114
Female,301,536,79,184,22٫12,223,154,269,115
Female,301,544,78,180,21٫84,226,148,241,93
Female,301,544,80,197,22٫4,232,157,265,108
Female,301,546,79,194,22٫12,234,146,242,96
Female,301,546,82,192,22٫96,223,157,257,100
Female,301,548,78,192,21٫84,234,154,248,94
Female,301,551,75,177,21,231,153,269,116
Female,301,551,77,183,21٫56,228,147,258,111
Female,301,551,80,187,22٫4,225,153,255,102
Female,301,553,77,183,21٫56,229,155,271,116
Female,301,553,80,182,22٫4,232,152,268,116
Female,301,554,74,175,20٫72,225,146,245,99
Female,301,554,75,186,21,224,158,273,115
Female,301,555,75,176,21,225,146,251,105
Female,301,564,78,183,21٫84,235,155,264,109
Female,301,564,78,183,21٫84,237,153,252,99
Female,301,565,77,181,21٫56,232,152,256,104
Female,301,566,80,188,22٫4,234,148,260,112
Female,301,572,74,180,20٫72,240,154,251,97
Female,301,572,80,186,22٫4,229,159,271,112
Female,301,576,77,179,21٫56,228,150,261,111
Female,302,538,74,173,20٫72,223,148,244,96
Female,302,542,78,187,21٫84,221,150,274,124
Female,302,543,78,183,21٫84,219,160,254,94
Female,302,543,79,188,22٫12,235,148,256,108
Female,302,545,79,193,22٫12,222,157,267,110
Female,302,546,76,186,21٫28,228,148,248,100
Female,302,546,77,194,21٫56,224,154,282,128
Female,302,547,76,184,21٫28,242,146,249,103
Female,302,547,77,185,21٫56,232,145,246,101
Female,302,548,74,180,20٫72,235,152,270,118
Female,302,549,76,180,21٫28,223,155,282,127
Female,302,550,80,188,22٫4,224,145,264,119
Female,302,552,80,186,22٫4,227,162,271,109
Female,302,553,74,178,20٫72,234,153,272,119
Female,302,553,75,177,21,232,144,245,101
Female,302,557,79,185,22٫12,232,151,257,106
Female,302,557,79,193,22٫12,237,161,255,94
Female,302,559,76,177,21٫28,236,146,245,99
Female,302,561,82,189,22٫96,226,152,262,110
Female,302,561,83,195,23٫24,227,164,290,126
Female,302,563,78,185,21٫84,231,159,278,119
Female,302,566,74,174,20٫72,238,145,241,96
Female,302,567,78,188,21٫84,232,150,240,90
Female,302,570,77,181,21٫56,241,151,246,95
Female,302,570,81,193,22٫68,237,160,287,127
Female,302,572,75,183,21,230,151,250,99
Female,302,575,80,187,22٫4,242,151,244,93
Female,302,576,82,192,22٫96,233,153,247,94
Female,303,528,78,190,21٫84,225,165,293,128
Female,303,529,77,183,21٫56,222,146,247,101
Female,303,532,79,193,22٫12,226,163,294,131
Female,303,534,77,182,21٫56,227,151,264,113
Female,303,534,80,197,22٫4,219,158,271,113
Female,303,535,77,182,21٫56,230,147,261,114
Female,303,545,76,180,21٫28,223,148,258,110
Female,303,548,80,190,22٫4,223,151,247,96
Female,303,549,74,184,20٫72,226,150,268,118
Female,303,549,80,192,22٫4,233,151,268,117
Female,303,550,74,178,20٫72,232,146,264,118
Female,303,550,75,181,21,225,147,252,105
Female,303,551,78,180,21٫84,238,150,273,123
Female,303,553,75,182,21,235,147,246,99
Female,303,553,81,193,22٫68,226,157,274,117
Female,303,554,72,176,20٫16,229,149,248,99
Female,303,556,80,191,22٫4,223,155,273,118
Female,303,558,78,191,21٫84,232,154,272,118
Female,303,560,81,193,22٫68,235,146,239,93
Female,303,561,77,191,21٫56,227,150,267,117
Female,303,561,78,186,21٫84,234,154,252,98
Female,303,562,74,177,20٫72,235,154,260,106
Female,303,563,77,184,21٫56,234,153,266,113
Female,303,563,82,195,22٫96,238,156,281,125
Female,303,564,80,192,22٫4,237,165,276,111
Female,303,565,75,176,21,241,147,271,124
Female,303,568,77,182,21٫56,234,150,266,116
Female,303,569,77,175,21٫56,237,152,248,96
Female,303,570,79,184,22٫12,234,143,238,95
Female,303,572,76,180,21٫28,237,150,251,101
Female,303,572,78,188,21٫84,229,153,246,93
Female,304,537,79,184,22٫12,227,154,255,101
Female,304,542,74,176,20٫72,225,149,246,97
Female,304,542,78,182,21٫84,232,150,250,100
Female,304,543,80,191,22٫4,223,159,287,128
Female,304,547,80,189,22٫4,227,163,275,112
Female,304,550,72,174,20٫16,223,149,250,101
Female,304,550,76,173,21٫28,226,152,262,110
Female,304,550,77,185,21٫56,229,156,273,117
Female,304,551,78,184,21٫84,227,155,280,125
Female,304,557,77,182,21٫56,227,149,238,89
Female,304,559,85,200,23٫8,231,163,277,114
Female,304,560,74,176,20٫72,237,154,259,105
Female,304,560,80,186,22٫4,235,157,260,103
Female,304,563,76,184,21٫28,240,154,254,100
Female,304,564,79,183,22٫12,233,146,246,100
Female,304,567,80,187,22٫4,232,155,260,105
Female,304,568,82,190,22٫96,231,153,250,97
Female,304,579,74,178,20٫72,243,153,268,115
Female,304,582,75,174,21,246,148,260,112
Female,305,531,79,193,22٫12,225,147,250,103
Female,305,537,79,190,22٫12,225,155,264,109
Female,305,541,75,178,21,228,145,261,116
Female,305,541,75,180,21,224,148,247,99
Female,305,542,77,181,21٫56,232,147,256,109
Female,305,543,74,184,20٫72,228,149,256,107
Female,305,544,75,179,21,225,152,249,97
Female,305,544,77,181,21٫56,229,150,267,117
Female,305,544,80,189,22٫4,234,158,257,99
Female,305,549,77,182,21٫56,230,151,251,100
Female,305,551,72,176,20٫16,230,145,264,119
Female,305,551,73,174,20٫44,228,143,248,105
Female,305,551,74,178,20٫72,227,150,256,106
Female,305,552,78,182,21٫84,241,145,240,95
Female,305,552,80,192,22٫4,224,158,275,117
Female,305,553,76,180,21٫28,233,152,255,103
Female,305,555,75,178,21,226,146,240,94
Female,305,555,77,180,21٫56,228,157,254,97
Female,305,555,77,185,21٫56,236,154,275,121
Female,305,555,80,196,22٫4,233,162,265,103
Female,305,557,78,188,21٫84,233,150,242,92
Female,305,558,78,186,21٫84,234,154,256,102
Female,305,559,78,187,21٫84,222,159,258,99
Female,305,560,72,174,20٫16,235,148,240,92
Female,305,560,80,188,22٫4,237,156,268,112
Female,305,561,75,177,21,231,150,258,108
Female,305,562,74,174,20٫72,235,153,274,121
Female,305,563,76,175,21٫28,238,144,252,108
Female,305,563,77,187,21٫56,231,154,272,118
Female,305,565,77,183,21٫56,237,147,267,120
Female,305,566,75,176,21,234,153,272,119
Female,305,567,78,185,21٫84,231,157,273,116
Female,305,568,73,181,20٫44,241,149,254,105
Female,305,569,79,185,22٫12,228,150,252,102
Female,305,573,76,183,21٫28,240,152,268,116
Female,305,575,79,190,22٫12,241,164,282,118
Female,305,577,78,184,21٫84,233,158,267,109
Female,305,578,76,190,21٫28,236,147,257,110
Female,305,584,75,176,21,233,146,244,98
Female,306,536,78,185,21٫84,231,152,260,108
Female,306,542,83,198,23٫24,221,157,270,113
Female,306,543,79,185,22٫12,221,160,256,96
Female,306,546,73,180,20٫44,223,149,247,98
Female,306,546,78,188,21٫84,225,153,246,93
Female,306,549,80,184,22٫4,231,159,281,122
Female,306,551,73,183,20٫44,226,146,266,120
Female,306,551,74,177,20٫72,230,146,258,112
Female,306,553,78,182,21٫84,231,159,286,127
Female,306,555,72,178,20٫16,230,149,239,90
Female,306,555,77,182,21٫56,236,152,250,98
Female,306,555,78,197,21٫84,231,160,271,111
Female,306,557,78,185,21٫84,241,154,265,111
Female,306,558,77,193,21٫56,236,154,258,104
Female,306,560,77,182,21٫56,237,152,262,110
Female,306,560,80,183,22٫4,236,146,246,100
Female,306,561,80,185,22٫4,237,146,255,109
Female,306,561,81,189,22٫68,232,151,272,121
Female,306,562,75,187,21,239,158,269,111
Female,306,564,80,187,22٫4,231,156,267,111
Female,306,566,74,177,20٫72,236,146,246,100
Female,306,566,74,182,20٫72,234,149,270,121
Female,306,566,77,182,21٫56,239,152,272,120
Female,306,566,80,182,22٫4,241,148,256,108
Female,306,569,78,184,21٫84,228,144,259,115
Female,306,569,78,186,21٫84,241,155,277,122
Female,306,569,81,188,22٫68,239,154,263,109
Female,306,572,75,183,21,239,144,243,99
Female,306,574,77,182,21٫56,240,146,256,110
Female,306,574,77,183,21٫56,239,155,285,130
Female,306,575,82,193,22٫96,239,155,276,121
Female,306,578,78,188,21٫84,239,164,268,104
Female,306,583,78,186,21٫84,246,162,261,99
Female,307,540,76,183,21٫28,238,155,284,129
Female,307,540,80,193,22٫4,220,158,288,130
Female,307,543,75,183,21,236,146,243,97
Female,307,547,73,178,20٫44,225,152,264,112
Female,307,547,78,188,21٫84,224,149,259,110
Female,307,552,80,188,22٫4,230,153,244,91
Female,307,553,77,179,21٫56,225,150,264,114
Female,307,553,83,194,23٫24,233,161,283,122
Female,307,554,83,201,23٫24,243,154,260,106
Female,307,556,73,177,20٫44,231,152,261,109
Female,307,556,77,188,21٫56,231,154,263,109
Female,307,561,75,187,21,237,160,264,104
Female,307,561,82,192,22٫96,233,157,271,114
Female,307,562,78,187,21٫84,229,155,253,98
Female,307,562,79,189,22٫12,237,153,249,96
Female,307,563,81,193,22٫68,238,163,285,122
Female,307,564,81,188,22٫68,221,157,275,118
Female,307,566,76,187,21٫28,234,162,283,121
Female,307,569,75,177,21,236,149,251,102
Female,307,569,80,186,22٫4,232,155,255,100
Female,307,570,77,180,21٫56,237,152,256,104
Female,307,572,82,197,22٫96,238,154,253,99
Female,307,576,78,190,21٫84,224,164,270,106
Female,307,579,80,186,22٫4,231,153,259,106
Female,307,583,80,189,22٫4,238,159,274,115
Female,307,584,77,180,21٫56,244,152,249,97
Female,307,585,75,183,21,234,154,250,96
Female,308,534,80,190,22٫4,220,159,274,115
Female,308,535,81,188,22٫68,220,154,250,96
Female,308,539,74,174,20٫72,231,144,250,106
Female,308,542,76,186,21٫28,221,156,257,101
Female,308,542,79,187,22٫12,228,153,257,104
Female,308,544,76,179,21٫28,224,151,280,129
Female,308,546,73,177,20٫44,226,146,236,90
Female,308,548,74,175,20٫72,227,153,264,111
Female,308,548,78,182,21٫84,220,158,279,121
Female,308,548,79,186,22٫12,229,161,282,121
Female,308,549,77,182,21٫56,227,150,258,108
Female,308,549,80,193,22٫4,232,153,260,107
Female,308,549,83,196,23٫24,228,164,287,123
Female,308,553,75,182,21,222,152,253,101
Female,308,554,77,187,21٫56,233,159,291,132
Female,308,556,75,185,21,226,143,248,105
Female,308,556,77,193,21٫56,232,156,248,92
Female,308,556,78,175,21٫84,241,151,256,105
Female,308,557,77,188,21٫56,235,154,267,113
Female,308,558,77,188,21٫56,232,158,278,120
Female,308,559,72,176,20٫16,226,144,235,91
Female,308,560,76,180,21٫28,234,153,255,102
Female,308,561,72,175,20٫16,237,151,246,95
Female,308,562,76,183,21٫28,236,162,261,99
Female,308,563,75,184,21,234,154,253,99
Female,308,563,77,187,21٫56,229,152,268,116
Female,308,564,79,195,22٫12,238,158,262,104
Female,308,564,80,184,22٫4,228,153,256,103
Female,308,565,78,183,21٫84,229,157,257,100
Female,308,567,75,183,21,234,159,265,106
Female,308,567,76,184,21٫28,245,150,239,89
Female,308,569,74,182,20٫72,232,147,245,98
Female,308,569,83,194,23٫24,235,156,286,130
Female,308,570,73,178,20٫44,236,155,271,116
Female,308,571,78,186,21٫84,238,147,268,121
Female,308,571,80,191,22٫4,245,152,281,129
Female,308,572,76,181,21٫28,227,153,265,112
Female,308,572,78,187,21٫84,237,161,260,99
Female,308,573,81,190,22٫68,234,147,258,111
Female,308,575,78,187,21٫84,236,159,254,95
Female,308,576,72,173,20٫16,237,154,253,99
Female,308,576,79,183,22٫12,245,156,263,107
Female,308,577,79,184,22٫12,241,147,270,123
Female,308,579,78,181,21٫84,238,146,240,94
Female,308,586,82,191,22٫96,237,145,263,118
Female,308,589,78,182,21٫84,244,154,266,112
Female,309,535,74,174,20٫72,222,150,245,95
Female,309,538,82,195,22٫96,233,151,253,102
Female,309,542,77,190,21٫56,228,152,272,120
Female,309,544,77,188,21٫56,224,150,244,94
Female,309,550,73,178,20٫44,233,147,254,107
Female,309,550,75,176,21,233,149,258,109
Female,309,551,74,185,20٫72,234,152,268,116
Female,309,553,78,190,21٫84,239,158,267,109
Female,309,553,78,192,21٫84,228,159,263,104
Female,309,554,83,200,23٫24,237,160,277,117
Female,309,557,78,185,21٫84,234,152,248,96
Female,309,558,77,187,21٫56,234,150,277,127
Female,309,563,81,190,22٫68,226,152,253,101
Female,309,564,77,190,21٫56,233,151,251,100
Female,309,564,79,183,22٫12,232,154,262,108
Female,309,566,73,182,20٫44,228,154,252,98
Female,309,568,79,188,22٫12,230,157,256,99
Female,309,574,79,191,22٫12,237,152,260,108
Female,309,577,73,173,20٫44,245,153,268,115
Female,309,578,74,177,20٫72,242,153,272,119
Female,309,583,78,192,21٫84,247,153,260,107
Female,309,584,74,180,20٫72,240,150,278,128
Female,309,584,78,190,21٫84,236,160,277,117
Female,309,587,78,186,21٫84,238,152,271,119
Female,309,596,74,178,20٫72,237,155,250,95
Female,310,543,79,190,22٫12,225,151,245,94
Female,310,546,81,188,22٫68,238,156,266,110
Female,310,548,78,181,21٫84,224,151,270,119
Female,310,548,78,192,21٫84,233,149,247,98
Female,310,551,77,187,21٫56,234,154,269,115
Female,310,554,77,186,21٫56,240,145,263,118
Female,310,556,77,192,21٫56,242,162,256,94
Female,310,556,80,196,22٫4,230,155,247,92
Female,310,557,75,175,21,226,150,243,93
Female,310,558,79,187,22٫12,232,148,259,111
Female,310,562,79,192,22٫12,237,155,264,109
Female,310,563,80,188,22٫4,240,160,257,97
Female,310,563,83,202,23٫24,230,162,269,107
Female,310,565,77,190,21٫56,234,152,256,104
Female,310,565,78,183,21٫84,233,150,256,106
Female,310,567,75,176,21,237,155,283,128
Female,310,567,78,182,21٫84,241,146,256,110
Female,310,568,74,177,20٫72,243,152,269,117
Female,310,569,77,183,21٫56,238,154,267,113
Female,310,570,75,177,21,241,145,246,101
Female,310,570,78,187,21٫84,236,153,270,117
Female,310,570,80,191,22٫4,236,166,274,108
Female,310,572,74,177,20٫72,241,153,265,112
Female,310,572,79,193,22٫12,241,153,243,90
Female,310,574,77,173,21٫56,234,151,251,100
Female,310,574,78,185,21٫84,232,150,267,117
Female,310,574,83,197,23٫24,231,167,280,113
Female,310,575,75,179,21,240,150,256,106
Female,310,576,77,180,21٫56,244,150,262,112
Female,310,579,77,187,21٫56,239,155,254,99
Female,310,579,77,188,21٫56,244,160,275,115
Female,310,579,80,187,22٫4,237,156,259,103
Female,310,580,77,187,21٫56,242,145,241,96
Female,310,581,77,187,21٫56,251,152,259,107
Female,310,586,80,191,22٫4,232,157,282,125
Female,310,588,79,183,22٫12,237,164,288,124
Female,310,591,75,175,21,241,145,256,111
Female,310,598,77,191,21٫56,238,161,270,109
Female,311,543,82,188,22٫96,230,158,279,121
Female,311,544,73,178,20٫44,222,154,272,118
Female,311,546,75,181,21,236,155,253,98
Female,311,548,74,182,20٫72,235,150,258,108
Female,311,548,81,191,22٫68,230,153,261,108
Female,311,553,72,174,20٫16,239,144,245,101
Female,311,554,75,183,21,229,148,246,98
Female,311,556,76,182,21٫28,232,153,271,118
Female,311,556,81,185,22٫68,232,145,244,99
Female,311,559,77,180,21٫56,236,151,257,106
Female,311,559,78,188,21٫84,235,161,278,117
Female,311,560,75,179,21,238,146,250,104
Female,311,560,76,182,21٫28,226,150,253,103
Female,311,561,74,178,20٫72,239,147,274,127
Female,311,562,74,175,20٫72,234,147,267,120
Female,311,563,78,185,21٫84,230,146,250,104
Female,311,565,74,178,20٫72,232,151,251,100
Female,311,565,74,181,20٫72,234,157,268,111
Female,311,565,76,181,21٫28,237,149,238,89
Female,311,565,78,188,21٫84,241,162,290,128
Female,311,567,78,190,21٫84,237,159,272,113
Female,311,567,83,200,23٫24,232,158,280,122
Female,311,569,75,187,21,241,151,265,114
Female,311,570,74,177,20٫72,233,146,243,97
Female,311,571,77,187,21٫56,239,155,277,122
Female,311,572,79,185,22٫12,244,162,260,98
Female,311,573,76,189,21٫28,241,150,264,114
Female,311,573,77,187,21٫56,232,152,268,116
Female,311,575,77,186,21٫56,234,152,254,102
Female,311,576,75,183,21,246,154,281,127
Female,311,576,81,191,22٫68,235,157,256,99
Female,311,579,78,187,21٫84,240,157,266,109
Female,311,580,79,191,22٫12,241,161,271,110
Female,311,582,78,185,21٫84,241,147,238,91
Female,311,582,82,194,22٫96,237,163,283,120
Female,311,583,81,194,22٫68,240,152,257,105
Female,311,584,83,196,23٫24,241,165,274,109
Female,311,586,77,182,21٫56,236,163,261,98
Female,311,590,78,184,21٫84,247,153,253,100
Female,311,590,78,187,21٫84,241,158,276,118
Female,311,591,81,190,22٫68,244,155,266,111
Female,311,592,74,180,20٫72,241,150,250,100
Female,312,536,74,176,20٫72,229,152,264,112
Female,312,541,82,197,22٫96,227,163,282,119
Female,312,552,72,177,20٫16,241,143,247,104
Female,312,552,76,187,21٫28,235,163,295,132
Female,312,555,76,182,21٫28,234,157,275,118
Female,312,557,75,180,21,228,153,248,95
Female,312,559,75,177,21,228,149,241,92
Female,312,560,78,191,21٫84,239,152,262,110
Female,312,560,78,194,21٫84,226,161,262,101
Female,312,561,80,187,22٫4,233,152,264,112
Female,312,561,80,187,22٫4,238,157,283,126
Female,312,562,81,202,22٫68,235,167,262,95
Female,312,564,79,193,22٫12,244,156,258,102
Female,312,564,80,187,22٫4,239,155,270,115
Female,312,564,83,195,23٫24,224,156,250,94
Female,312,567,76,183,21٫28,234,154,260,106
Female,312,567,79,191,22٫12,235,149,258,109
Female,312,568,77,188,21٫56,241,152,243,91
Female,312,570,77,187,21٫56,235,155,247,92
Female,312,570,79,183,22٫12,237,152,254,102
Female,312,571,80,197,22٫4,240,159,284,125
Female,312,572,75,175,21,232,146,245,99
Female,312,573,80,187,22٫4,232,155,283,128
Female,312,575,81,193,22٫68,237,157,265,108
Female,312,575,81,199,22٫68,237,160,264,104
Female,312,579,77,184,21٫56,244,151,261,110
Female,312,579,82,193,22٫96,238,164,295,131
Female,312,580,73,175,20٫44,240,153,248,95
Female,312,581,76,187,21٫28,237,160,263,103
Female,312,581,78,192,21٫84,245,163,268,105
Female,312,581,80,189,22٫4,256,150,258,108
Female,312,585,75,182,21,238,156,270,114
Female,312,586,78,188,21٫84,246,156,266,110
Female,312,587,77,187,21٫56,238,154,250,96
Female,312,588,79,188,22٫12,243,160,263,103
Female,312,589,76,177,21٫28,242,146,252,106
Female,312,609,74,173,20٫72,244,152,263,111
Female,313,534,77,183,21٫56,224,161,284,123
Female,313,538,77,187,21٫56,220,149,256,107
Female,313,552,79,185,22٫12,241,162,278,116
Female,313,553,77,184,21٫56,236,149,265,116
Female,313,553,77,187,21٫56,234,157,261,104
Female,313,557,80,192,22٫4,233,163,259,96
Female,313,558,74,177,20٫72,230,143,246,103
Female,313,558,77,188,21٫56,240,154,273,119
Female,313,560,81,190,22٫68,245,158,257,99
Female,313,560,85,193,23٫8,234,160,284,124
Female,313,561,77,186,21٫56,233,155,273,118
Female,313,563,75,175,21,236,146,240,94
Female,313,563,80,194,22٫4,237,162,266,104
Female,313,566,73,173,20٫44,238,143,237,94
Female,313,567,72,180,20٫16,247,151,243,92
Female,313,567,83,197,23٫24,237,167,272,105
Female,313,569,78,183,21٫84,241,157,260,103
Female,313,570,77,182,21٫56,239,150,245,95
Female,313,572,81,192,22٫68,230,162,256,94
Female,313,574,78,183,21٫84,233,154,254,100
Female,313,576,78,187,21٫84,245,151,256,105
Female,313,576,80,185,22٫4,233,148,260,112
Female,313,578,81,191,22٫68,235,156,275,119
Female,313,579,72,177,20٫16,244,156,246,90
Female,313,579,75,181,21,241,154,251,97
Female,313,580,76,178,21٫28,240,146,250,104
Female,313,586,75,182,21,248,152,255,103
Female,314,528,78,187,21٫84,225,153,258,105
Female,314,538,81,200,22٫68,235,164,278,114
Female,314,555,75,179,21,235,157,264,107
Female,314,555,76,180,21٫28,237,153,270,117
Female,314,556,84,198,23٫52,235,156,256,100
Female,314,560,74,173,20٫72,234,150,282,132
Female,314,561,76,179,21٫28,239,152,254,102
Female,314,562,77,183,21٫56,236,150,267,117
Female,314,564,74,181,20٫72,234,148,272,124
Female,314,564,76,182,21٫28,241,148,251,103
Female,314,564,84,202,23٫52,241,158,285,127
Female,314,565,73,177,20٫44,235,145,241,96
Female,314,565,76,177,21٫28,235,153,256,103
Female,314,566,80,187,22٫4,241,152,253,101
Female,314,567,76,181,21٫28,236,149,246,97
Female,314,568,83,193,23٫24,236,157,281,124
Female,314,569,77,182,21٫56,243,151,262,111
Female,314,569,77,190,21٫56,234,156,289,133
Female,314,573,74,180,20٫72,238,153,270,117
Female,314,573,76,180,21٫28,234,152,244,92
Female,314,573,78,194,21٫84,236,154,259,105
Female,314,573,79,194,22٫12,238,152,264,112
Female,314,575,82,192,22٫96,228,154,270,116
Female,314,575,83,195,23٫24,239,155,248,93
Female,314,576,79,183,22٫12,234,161,278,117
Female,314,576,79,186,22٫12,242,154,251,97
Female,314,578,75,177,21,239,155,253,98
Female,314,579,77,186,21٫56,235,159,269,110
Female,314,580,78,185,21٫84,236,157,265,108
Female,314,580,80,194,22٫4,244,162,290,128
Female,314,583,81,191,22٫68,237,158,276,118
Female,314,583,85,201,23٫8,240,166,274,108
Female,314,585,77,182,21٫56,247,154,243,89
Female,314,585,77,192,21٫56,242,159,286,127
Female,314,585,78,187,21٫84,241,147,248,101
Female,314,585,78,193,21٫84,238,157,285,128
Female,314,587,74,176,20٫72,253,145,243,98
Female,314,588,78,187,21٫84,249,154,259,105
Female,314,591,77,190,21٫56,242,160,275,115
Female,314,592,77,187,21٫56,241,160,274,114
Female,314,598,80,189,22٫4,244,155,246,91
Female,314,606,81,189,22٫68,245,162,264,102
Female,315,537,75,182,21,220,154,265,111
Female,315,545,83,200,23٫24,225,157,267,110
Female,315,546,74,183,20٫72,226,150,255,105
Female,315,551,74,184,20٫72,242,148,276,128
Female,315,554,76,177,21٫28,239,149,252,103
Female,315,554,76,182,21٫28,237,145,257,112
Female,315,554,82,197,22٫96,234,158,255,97
Female,315,557,82,195,22٫96,227,158,273,115
Female,315,559,79,187,22٫12,232,150,262,112
Female,315,560,80,197,22٫4,236,162,277,115
Female,315,560,81,197,22٫68,232,156,269,113
Female,315,562,77,188,21٫56,233,152,262,110
Female,315,564,77,187,21٫56,238,152,250,98
Female,315,565,74,178,20٫72,238,151,248,97
Female,315,568,77,178,21٫56,234,149,244,95
Female,315,568,78,192,21٫84,236,160,289,129
Female,315,569,80,188,22٫4,235,161,291,130
Female,315,571,73,181,20٫44,233,156,264,108
Female,315,571,81,195,22٫68,238,160,268,108
Female,315,571,82,198,22٫96,246,162,264,102
Female,315,572,76,176,21٫28,238,154,270,116
Female,315,572,81,188,22٫68,239,153,281,128
Female,315,573,74,182,20٫72,242,163,296,133
Female,315,574,82,192,22٫96,234,167,285,118
Female,315,574,84,198,23٫52,244,161,260,99
Female,315,575,72,173,20٫16,244,146,258,112
Female,315,575,75,178,21,241,158,266,108
Female,315,576,76,179,21٫28,231,147,257,110
Female,315,576,79,190,22٫12,242,154,256,102
Female,315,576,82,196,22٫96,248,163,283,120
Female,315,579,73,174,20٫44,238,147,240,93
Female,315,579,82,202,22٫96,237,160,268,108
Female,315,580,76,178,21٫28,243,150,253,103
Female,315,580,79,185,22٫12,248,149,260,111
Female,315,581,77,176,21٫56,241,155,278,123
Female,315,581,83,194,23٫24,249,150,255,105
Female,315,582,78,183,21٫84,242,155,262,107
Female,315,583,78,179,21٫84,250,151,247,96
Female,315,584,76,181,21٫28,246,153,263,110
Female,315,584,78,186,21٫84,247,157,278,121
Female,315,586,74,182,20٫72,249,155,257,102
Female,315,588,80,188,22٫4,247,156,245,89
Female,315,591,79,187,22٫12,244,160,251,91
Female,315,592,75,179,21,238,149,247,98
Female,315,593,80,197,22٫4,244,168,287,119
Female,315,595,77,177,21٫56,256,150,245,95
Female,315,595,80,188,22٫4,240,160,271,111
Female,315,598,77,183,21٫56,247,144,271,127
Female,315,602,79,189,22٫12,247,151,258,107
Female,315,603,84,198,23٫52,253,160,264,104
Female,316,541,83,195,23٫24,227,158,268,110
Female,316,547,77,183,21٫56,236,149,245,96
Female,316,549,75,182,21,226,157,269,112
Female,316,559,79,186,22٫12,240,149,249,100
Female,316,560,79,185,22٫12,239,154,255,101
Female,316,561,77,184,21٫56,247,146,243,97
Female,316,562,75,182,21,235,152,265,113
Female,316,562,82,190,22٫96,241,159,261,102
Female,316,563,77,187,21٫56,238,164,258,94
Female,316,564,73,188,20٫44,234,153,256,103
Female,316,565,76,178,21٫28,233,148,250,102
Female,316,566,74,182,20٫72,244,154,264,110
Female,316,567,80,185,22٫4,241,158,263,105
Female,316,567,83,200,23٫24,235,165,261,96
Female,316,568,75,183,21,232,154,249,95
Female,316,568,76,187,21٫28,238,151,255,104
Female,316,568,83,193,23٫24,239,152,265,113
Female,316,569,79,181,22٫12,244,143,235,92
Female,316,570,81,195,22٫68,238,168,290,122
Female,316,572,75,182,21,246,150,249,99
Female,316,572,77,183,21٫56,240,150,248,98
Female,316,574,80,190,22٫4,244,154,278,124
Female,316,576,83,197,23٫24,238,156,275,119
Female,316,579,76,181,21٫28,238,162,268,106
Female,316,579,79,183,22٫12,239,154,255,101
Female,316,580,78,192,21٫84,246,164,281,117
Female,316,580,80,186,22٫4,245,152,259,107
Female,316,581,79,192,22٫12,234,158,272,114
Female,316,582,74,179,20٫72,234,145,264,119
Female,316,583,75,177,21,247,153,256,103
Female,316,584,78,180,21٫84,249,166,294,128
Female,316,586,75,173,21,244,156,260,104
Female,316,586,83,187,23٫24,240,161,264,103
Female,316,587,81,187,22٫68,251,152,268,116
Female,316,591,80,190,22٫4,240,160,268,108
Female,316,595,75,186,21,261,154,246,92
Female,316,599,81,192,22٫68,245,153,257,104
Female,316,604,79,184,22٫12,254,158,273,115
Female,317,556,81,185,22٫68,234,149,272,123
Female,317,559,76,187,21٫28,239,158,275,117
Female,317,562,77,182,21٫56,246,154,252,98
Female,317,562,81,192,22٫68,239,154,271,117
Female,317,563,74,180,20٫72,233,152,262,110
Female,317,565,75,177,21,240,153,251,98
Female,317,565,82,191,22٫96,237,156,265,109
Female,317,566,76,186,21٫28,236,147,240,93
Female,317,567,75,182,21,232,151,248,97
Female,317,567,75,184,21,231,152,286,134
Female,317,568,74,183,20٫72,234,152,280,128
Female,317,568,78,185,21٫84,246,145,258,113
Female,317,568,83,196,23٫24,243,167,280,113
Female,317,570,80,190,22٫4,232,157,273,116
Female,317,571,79,193,22٫12,231,160,266,106
Female,317,571,80,191,22٫4,237,163,266,103
Female,317,571,82,190,22٫96,241,150,260,110
Female,317,572,80,197,22٫4,240,158,263,105
Female,317,575,74,185,20٫72,245,155,253,98
Female,317,576,76,190,21٫28,242,162,282,120
Female,317,577,77,184,21٫56,242,159,290,131
Female,317,578,79,194,22٫12,239,154,257,103
Female,317,578,80,193,22٫4,243,150,271,121
Female,317,578,83,195,23٫24,245,161,266,105
Female,317,579,75,182,21,241,155,262,107
Female,317,579,77,181,21٫56,241,149,256,107
Female,317,579,77,197,21٫56,245,162,273,111
Female,317,580,74,181,20٫72,242,158,281,123
Female,317,580,75,183,21,247,149,264,115
Female,317,583,81,190,22٫68,239,155,259,104
Female,317,584,77,183,21٫56,245,152,269,117
Female,317,584,78,182,21٫84,248,150,262,112
Female,317,584,79,188,22٫12,238,158,270,112
Female,317,587,72,178,20٫16,245,151,263,112
Female,317,587,82,192,22٫96,247,153,257,104
Female,317,593,74,177,20٫72,248,150,242,92
Female,317,597,75,181,21,238,154,272,118
Female,317,599,84,196,23٫52,246,159,270,111
Female,317,603,80,183,22٫4,243,146,255,109
Female,317,610,75,180,21,242,159,277,118
Female,318,556,78,188,21٫84,234,157,277,120
Female,318,556,80,185,22٫4,237,157,273,116
Female,318,556,82,193,22٫96,238,155,264,109
Female,318,556,83,193,23٫24,233,164,281,117
Female,318,560,78,186,21٫84,240,152,263,111
Female,318,561,79,191,22٫12,243,163,282,119
Female,318,561,79,193,22٫12,236,158,265,107
Female,318,562,78,188,21٫84,238,152,248,96
Female,318,563,78,178,21٫84,230,152,262,110
Female,318,563,78,188,21٫84,239,154,259,105
Female,318,568,72,175,20٫16,243,150,247,97
Female,318,569,77,177,21٫56,238,152,259,107
Female,318,569,78,179,21٫84,237,159,251,92
Female,318,569,79,190,22٫12,241,157,248,91
Female,318,569,81,197,22٫68,238,161,277,116
Female,318,571,79,191,22٫12,249,153,274,121
Female,318,571,80,186,22٫4,243,154,273,119
Female,318,572,73,173,20٫44,238,148,245,97
Female,318,573,81,190,22٫68,245,154,270,116
Female,318,574,73,174,20٫44,248,150,270,120
Female,318,574,76,182,21٫28,240,147,245,98
Female,318,574,83,189,23٫24,243,156,258,102
Female,318,574,85,199,23٫8,246,149,260,111
Female,318,575,76,179,21٫28,246,155,284,129
Female,318,575,78,190,21٫84,243,157,276,119
Female,318,575,82,193,22٫96,245,151,276,125
Female,318,576,77,184,21٫56,247,150,251,101
Female,318,576,81,194,22٫68,240,160,284,124
Female,318,577,74,178,20٫72,245,150,253,103
Female,318,577,74,185,20٫72,239,161,275,114
Female,318,577,82,188,22٫96,244,155,249,94
Female,318,578,75,179,21,245,155,247,92
Female,318,579,75,182,21,243,147,244,97
Female,318,579,76,185,21٫28,233,153,259,106
Female,318,581,81,195,22٫68,245,159,250,91
Female,318,582,75,182,21,241,155,270,115
Female,318,583,77,183,21٫56,234,149,266,117
Female,318,584,81,193,22٫68,244,166,275,109
Female,318,586,77,184,21٫56,244,154,271,117
Female,318,586,79,193,22٫12,237,143,240,97
Female,318,586,80,197,22٫4,239,155,254,99
Female,318,589,79,188,22٫12,243,157,256,99
Female,318,592,78,187,21٫84,251,150,270,120
Female,318,592,80,192,22٫4,237,157,259,102
Female,318,594,78,185,21٫84,252,159,266,107
Female,318,599,77,183,21٫56,244,158,263,105
Female,318,602,77,187,21٫56,249,161,276,115
Female,318,602,78,184,21٫84,243,155,254,99
Female,318,614,81,194,22٫68,254,152,267,115
Female,319,555,81,196,22٫68,237,157,261,104
Female,319,560,78,193,21٫84,245,160,279,119
Female,319,560,82,190,22٫96,232,167,273,106
Female,319,562,78,186,21٫84,232,148,247,99
Female,319,565,74,177,20٫72,236,145,266,121
Female,319,567,80,191,22٫4,239,153,278,125
Female,319,569,77,190,21٫56,241,157,274,117
Female,319,570,78,180,21٫84,244,151,265,114
Female,319,571,75,185,21,242,162,285,123
Female,319,571,83,193,23٫24,244,162,278,116
Female,319,575,80,189,22٫4,242,150,242,92
Female,319,576,77,188,21٫56,245,156,253,97
Female,319,578,82,201,22٫96,236,166,262,96
Female,319,579,77,179,21٫56,244,152,262,110
Female,319,582,79,186,22٫12,237,155,267,112
Female,319,583,77,186,21٫56,249,145,272,127
Female,319,585,81,191,22٫68,239,154,250,96
Female,319,586,74,175,20٫72,236,146,248,102
Female,319,590,77,187,21٫56,251,158,250,92
Female,319,590,78,192,21٫84,239,161,281,120
Female,319,592,78,185,21٫84,238,157,256,99
Female,319,595,78,187,21٫84,250,160,267,107
Female,319,596,74,187,20٫72,244,151,247,96
Female,319,597,79,188,22٫12,248,161,263,102
Female,319,598,81,188,22٫68,248,158,256,98
Female,319,600,75,185,21,250,150,247,97
Female,319,602,77,183,21٫56,248,149,275,126
Female,319,607,79,191,22٫12,257,152,279,127
Female,320,560,83,190,23٫24,229,159,273,114
Female,320,564,78,194,21٫84,235,155,264,109
Female,320,565,76,177,21٫28,241,154,249,95
Female,320,566,75,177,21,242,153,258,105
Female,320,566,80,188,22٫4,242,158,280,122
Female,320,567,82,187,22٫96,232,156,282,126
Female,320,569,73,180,20٫44,236,156,273,117
Female,320,570,79,185,22٫12,243,153,270,117
Female,320,570,80,187,22٫4,232,158,271,113
Female,320,572,74,177,20٫72,252,148,253,105
Female,320,572,77,188,21٫56,234,160,263,103
Female,320,572,83,195,23٫24,243,163,283,120
Female,320,572,84,200,23٫52,243,168,268,100
Female,320,573,80,186,22٫4,245,147,257,110
Female,320,574,77,191,21٫56,241,154,264,110
Female,320,575,81,200,22٫68,246,159,270,111
Female,320,576,78,186,21٫84,246,159,268,109
Female,320,578,73,173,20٫44,244,149,256,107
Female,320,578,84,197,23٫52,244,156,279,123
Female,320,580,82,192,22٫96,247,163,282,119
Female,320,583,75,176,21,234,147,251,104
Female,320,584,76,185,21٫28,244,155,259,104
Female,320,584,78,185,21٫84,239,149,245,96
Female,320,584,81,192,22٫68,247,158,275,117
Female,320,585,73,173,20٫44,246,146,239,93
Female,320,586,78,186,21٫84,246,149,245,96
Female,320,587,78,184,21٫84,240,153,261,108
Female,320,587,84,196,23٫52,246,157,286,129
Female,320,588,74,175,20٫72,251,145,240,95
Female,320,589,77,183,21٫56,241,156,252,96
Female,320,591,75,184,21,239,151,279,128
Female,320,591,84,197,23٫52,253,157,262,105
Female,320,595,78,187,21٫84,251,162,283,121
Female,320,596,75,180,21,239,161,260,99
Female,320,596,78,187,21٫84,252,154,244,90
Female,320,604,84,199,23٫52,249,159,279,120
Female,320,611,78,185,21٫84,242,156,272,116
Female,320,615,79,185,22٫12,249,154,264,110
Female,321,545,78,185,21٫84,236,148,268,120
Female,321,556,77,187,21٫56,244,150,260,110
Female,321,561,80,197,22٫4,235,164,257,93
Female,321,562,77,185,21٫56,241,152,266,114
Female,321,562,79,193,22٫12,237,160,262,102
Female,321,565,82,191,22٫96,244,159,267,108
Female,321,567,76,182,21٫28,240,158,263,105
Female,321,570,80,190,22٫4,239,150,265,115
Female,321,571,80,187,22٫4,244,150,258,108
Female,321,572,73,182,20٫44,244,157,269,112
Female,321,573,82,187,22٫96,242,155,262,107
Female,321,574,76,182,21٫28,241,152,267,115
Female,321,577,81,191,22٫68,241,155,277,122
Female,321,578,79,189,22٫12,245,150,249,99
Female,321,578,81,193,22٫68,245,167,281,114
Female,321,585,76,182,21٫28,244,150,268,118
Female,321,585,77,190,21٫56,249,154,254,100
Female,321,586,74,180,20٫72,241,155,253,98
Female,321,586,78,178,21٫84,247,150,254,104
Female,321,586,79,194,22٫12,248,153,259,106
Female,321,586,81,193,22٫68,246,162,258,96
Female,321,587,75,180,21,246,152,277,125
Female,321,588,84,197,23٫52,260,165,277,112
Female,321,590,75,180,21,251,150,246,96
Female,321,590,78,187,21٫84,243,159,272,113
Female,321,591,83,199,23٫24,247,168,278,110
Female,321,592,81,192,22٫68,248,163,281,118
Female,321,593,82,196,22٫96,251,165,286,121
Female,321,595,80,188,22٫4,239,154,260,106
Female,321,596,81,190,22٫68,242,162,283,121
Female,321,596,82,190,22٫96,245,155,269,114
Female,321,596,84,194,23٫52,251,166,286,120
Female,321,597,76,182,21٫28,254,153,277,124
Female,321,598,77,181,21٫56,246,150,243,93
Female,321,599,73,179,20٫44,244,153,270,117
Female,321,599,81,194,22٫68,247,156,262,106
Female,321,603,82,192,22٫96,250,155,280,125
Female,321,603,82,193,22٫96,255,167,262,95
Female,321,604,77,186,21٫56,251,150,268,118
Female,321,606,77,189,21٫56,246,153,287,134
Female,321,608,77,182,21٫56,260,147,256,109
Female,321,614,75,183,21,239,153,273,120
Female,321,616,79,188,22٫12,238,151,270,119
Female,322,558,81,189,22٫68,233,157,256,99
Female,322,559,79,194,22٫12,239,163,258,95
Female,322,564,78,186,21٫84,243,150,272,122
Female,322,565,74,179,20٫72,246,149,246,97
Female,322,568,74,177,20٫72,240,154,253,99
Female,322,568,76,188,21٫28,242,155,259,104
Female,322,568,78,190,21٫84,236,156,277,121
Female,322,570,81,188,22٫68,239,154,263,109
Female,322,572,78,193,21٫84,237,155,261,106
Female,322,572,80,195,22٫4,240,159,275,116
Female,322,573,74,176,20٫72,235,146,251,105
Female,322,579,79,180,22٫12,244,156,268,112
Female,322,581,79,192,22٫12,239,155,260,105
Female,322,583,78,192,21٫84,239,154,261,107
Female,322,584,77,190,21٫56,250,164,292,128
Female,322,584,80,187,22٫4,245,156,259,103
Female,322,585,78,186,21٫84,255,155,255,100
Female,322,585,81,193,22٫68,241,155,262,107
Female,322,585,83,195,23٫24,242,163,283,120
Female,322,588,78,178,21٫84,242,146,235,89
Female,322,589,74,182,20٫72,244,159,282,123
Female,322,589,75,178,21,258,156,250,94
Female,322,589,78,190,21٫84,248,148,243,95
Female,322,590,77,181,21٫56,250,162,279,117
Female,322,591,75,180,21,246,148,237,89
Female,322,592,83,192,23٫24,252,158,268,110
Female,322,593,77,189,21٫56,253,159,258,99
Female,322,593,79,183,22٫12,256,151,263,112
Female,322,593,79,187,22٫12,242,156,285,129
Female,322,593,79,195,22٫12,248,168,280,112
Female,322,595,78,193,21٫84,257,165,286,121
Female,322,598,75,185,21,248,158,260,102
Female,322,598,77,181,21٫56,248,161,268,107
Female,322,599,79,188,22٫12,255,158,267,109
Female,322,599,81,197,22٫68,245,165,271,106
Female,322,602,77,183,21٫56,255,148,255,107
Female,322,602,77,183,21٫56,256,151,246,95
Female,323,550,80,186,22٫4,246,164,291,127
Female,323,561,83,195,23٫24,233,160,285,125
Female,323,563,79,188,22٫12,243,154,260,106
Female,323,567,81,192,22٫68,240,150,277,127
Female,323,572,77,175,21٫56,247,149,258,109
Female,323,573,79,183,22٫12,243,160,266,106
Female,323,573,80,190,22٫4,236,163,262,99
Female,323,575,80,197,22٫4,240,162,291,129
Female,323,576,75,178,21,244,143,260,117
Female,323,578,80,193,22٫4,245,157,264,107
Female,323,580,75,181,21,240,156,273,117
Female,323,582,77,188,21٫56,247,152,256,104
Female,323,582,80,187,22٫4,240,163,264,101
Female,323,582,80,199,22٫4,245,157,268,111
Female,323,583,79,187,22٫12,242,157,276,119
Female,323,584,80,192,22٫4,242,162,258,96
Female,323,585,78,186,21٫84,243,158,255,97
Female,323,585,80,193,22٫4,247,157,270,113
Female,323,586,80,191,22٫4,255,153,258,105
Female,323,587,77,180,21٫56,246,161,260,99
Female,323,588,78,188,21٫84,243,155,256,101
Female,323,592,83,196,23٫24,240,155,248,93
Female,323,600,80,191,22٫4,247,157,261,104
Female,323,601,80,189,22٫4,261,158,248,90
Female,323,605,79,185,22٫12,245,146,249,103
Female,324,555,76,187,21٫28,227,154,251,97
Female,324,569,79,189,22٫12,243,152,263,111
Female,324,571,80,187,22٫4,255,161,283,122
Female,324,574,78,182,21٫84,238,151,264,113
Female,324,574,79,186,22٫12,241,149,249,100
Female,324,576,78,179,21٫84,246,156,265,109
Female,324,577,80,194,22٫4,243,159,265,106
Female,324,578,77,185,21٫56,249,150,263,113
Female,324,579,75,181,21,249,150,259,109
Female,324,579,78,189,21٫84,245,151,266,115
Female,324,579,78,193,21٫84,235,150,248,98
Female,324,580,76,186,21٫28,238,162,255,93
Female,324,581,76,188,21٫28,243,157,271,114
Female,324,582,77,178,21٫56,247,155,267,112
Female,324,583,79,192,22٫12,234,160,280,120
Female,324,585,79,183,22٫12,234,157,275,118
Female,324,586,78,183,21٫84,238,159,259,100
Female,324,587,77,193,21٫56,248,154,250,96
Female,324,588,78,186,21٫84,248,153,260,107
Female,324,588,80,190,22٫4,244,157,271,114
Female,324,590,81,192,22٫68,242,148,258,110
Female,324,592,80,190,22٫4,249,150,277,127
Female,324,592,81,190,22٫68,245,156,260,104
Female,324,594,80,190,22٫4,258,154,262,108
Female,324,595,79,187,22٫12,245,164,258,94
Female,324,595,82,195,22٫96,246,164,277,113
Female,324,597,76,177,21٫28,244,147,252,105
Female,324,598,78,187,21٫84,250,156,245,89
Female,324,601,85,201,23٫8,245,152,275,123
Female,324,604,81,196,22٫68,249,164,262,98
Female,324,611,82,196,22٫96,253,162,260,98
Female,325,551,77,189,21٫56,232,160,255,95
Female,325,568,77,183,21٫56,242,150,264,114
Female,325,571,84,195,23٫52,247,154,261,107
Female,325,573,80,190,22٫4,243,159,274,115
Female,325,577,78,192,21٫84,257,159,271,112
Female,325,577,83,196,23٫24,237,167,270,103
Female,325,579,77,179,21٫56,239,160,264,104
Female,325,580,79,182,22٫12,249,157,265,108
Female,325,580,79,188,22٫12,238,160,267,107
Female,325,581,77,186,21٫56,245,153,248,95
Female,325,581,81,192,22٫68,241,156,272,116
Female,325,581,83,197,23٫24,239,154,251,97
Female,325,582,81,193,22٫68,246,164,262,98
Female,325,583,75,179,21,243,150,243,93
Female,325,583,79,189,22٫12,240,165,267,102
Female,325,584,80,187,22٫4,240,162,289,127
Female,325,586,77,182,21٫56,253,151,245,94
Female,325,586,80,190,22٫4,248,163,260,97
Female,325,586,80,192,22٫4,249,158,263,105
Female,325,586,80,196,22٫4,249,161,272,111
Female,325,588,78,189,21٫84,241,158,252,94
Female,325,589,75,183,21,245,151,268,117
Female,325,590,80,187,22٫4,255,152,272,120
Female,325,590,83,195,23٫24,251,157,263,106
Female,325,591,79,186,22٫12,250,163,260,97
Female,325,592,80,194,22٫4,242,168,292,124
Female,325,593,74,182,20٫72,250,147,248,101
Female,325,593,75,182,21,239,150,261,111
Female,325,596,82,190,22٫96,247,156,268,112
Female,325,596,84,195,23٫52,251,160,249,89
Female,325,597,78,184,21٫84,251,164,272,108
Female,325,599,84,200,23٫52,260,163,266,103
Female,325,601,77,194,21٫56,254,153,272,119
Female,325,605,81,190,22٫68,247,163,273,110
Female,325,605,83,195,23٫24,258,157,260,103
Female,325,607,79,188,22٫12,249,158,256,98
Female,325,608,78,185,21٫84,252,153,278,125
Female,325,608,79,187,22٫12,246,152,248,96
Female,325,609,80,192,22٫4,254,149,255,106
Female,325,611,78,188,21٫84,256,164,266,102
Female,325,616,77,187,21٫56,248,154,258,104
Female,326,562,78,190,21٫84,232,164,284,120
Female,326,562,78,190,21٫84,246,160,284,124
Female,326,568,77,191,21٫56,245,168,292,124
Female,326,582,77,186,21٫56,245,150,279,129
Female,326,582,77,187,21٫56,253,154,274,120
Female,326,584,72,178,20٫16,248,149,251,102
Female,326,584,78,194,21٫84,234,160,266,106
Female,326,587,77,179,21٫56,242,151,265,114
Female,326,588,77,188,21٫56,248,152,251,99
Female,326,589,81,190,22٫68,256,160,271,111
Female,326,590,76,183,21٫28,246,153,263,110
Female,326,592,83,198,23٫24,248,162,280,118
Female,326,595,80,200,22٫4,247,157,269,112
Female,326,596,80,188,22٫4,244,163,277,114
Female,326,597,79,188,22٫12,258,150,255,105
Female,326,598,75,181,21,244,158,249,91
Female,326,599,78,178,21٫84,253,150,272,122
Female,326,600,78,177,21٫84,246,148,247,99
Female,326,600,78,188,21٫84,244,162,286,124
Female,326,606,83,198,23٫24,257,158,265,107
Female,326,608,80,197,22٫4,260,165,289,124
Female,326,617,75,176,21,256,151,282,131
Female,327,562,78,180,21٫84,245,151,252,101
Female,327,565,80,193,22٫4,241,155,267,112
Female,327,571,83,193,23٫24,246,159,259,100
Female,327,573,74,177,20٫72,234,152,250,98
Female,327,574,75,178,21,245,149,250,101
Female,327,577,83,191,23٫24,243,156,264,108
Female,327,580,82,192,22٫96,246,154,250,96
Female,327,583,75,173,21,239,151,248,97
Female,327,588,79,191,22٫12,248,156,270,114
Female,327,590,81,184,22٫68,252,151,268,117
Female,327,592,82,193,22٫96,251,150,252,102
Female,327,594,79,189,22٫12,254,158,251,93
Female,327,599,81,192,22٫68,252,152,247,95
Female,327,600,78,193,21٫84,261,154,255,101
Female,327,605,75,180,21,254,147,261,114
Female,327,607,81,194,22٫68,249,165,284,119
Female,327,613,76,188,21٫28,257,158,267,109
Female,328,563,81,193,22٫68,243,165,279,114
Female,328,565,79,187,22٫12,239,155,261,106
Female,328,568,80,187,22٫4,240,154,280,126
Female,328,571,80,190,22٫4,247,154,259,105
Female,328,572,78,187,21٫84,233,160,269,109
Female,328,578,74,182,20٫72,246,153,277,124
Female,328,578,78,187,21٫84,252,153,258,105
Female,328,580,74,176,20٫72,246,158,260,102
Female,328,581,78,186,21٫84,250,150,262,112
Female,328,581,79,189,22٫12,248,162,284,122
Female,328,584,79,187,22٫12,254,153,263,110
Female,328,584,83,195,23٫24,235,166,280,114
Female,328,585,77,192,21٫56,246,158,277,119
Female,328,585,83,194,23٫24,257,156,269,113
Female,328,588,80,197,22٫4,249,162,273,111
Female,328,589,81,193,22٫68,243,160,287,127
Female,328,590,80,189,22٫4,245,150,264,114
Female,328,590,81,195,22٫68,254,154,248,94
Female,328,591,81,197,22٫68,237,162,262,100
Female,328,596,79,190,22٫12,243,150,240,90
Female,328,596,83,199,23٫24,252,162,273,111
Female,328,598,78,185,21٫84,249,161,277,116
Female,328,601,84,198,23٫52,248,162,260,98
Female,328,601,85,197,23٫8,247,162,267,105
Female,328,610,78,186,21٫84,255,156,266,110
Female,328,618,74,183,20٫72,268,163,283,120
Female,329,574,83,202,23٫24,252,163,281,118
Female,329,575,74,187,20٫72,242,162,280,118
Female,329,578,82,192,22٫96,245,162,264,102
Female,329,579,78,187,21٫84,247,160,290,130
Female,329,581,82,187,22٫96,253,159,265,106
Female,329,582,75,188,21,255,148,246,98
Female,329,583,81,193,22٫68,239,158,267,109
Female,329,584,74,184,20٫72,249,150,280,130
Female,329,590,74,180,20٫72,249,151,267,116
Female,329,590,82,198,22٫96,253,158,284,126
Female,329,593,80,192,22٫4,251,158,257,99
Female,329,598,84,196,23٫52,257,162,272,110
Female,329,599,81,187,22٫68,254,155,251,96
Female,329,599,82,194,22٫96,247,166,284,118
Female,329,602,79,183,22٫12,250,152,252,100
Female,329,603,78,187,21٫84,251,162,288,126
Female,329,608,75,182,21,250,145,248,103
Female,329,610,84,201,23٫52,256,153,272,119
Female,329,611,77,192,21٫56,254,160,285,125
Female,329,611,81,193,22٫68,268,162,273,111
Female,329,613,75,176,21,266,143,248,105
Female,329,624,78,185,21٫84,250,157,273,116
Female,330,564,74,177,20٫72,242,145,267,122
Female,330,564,80,187,22٫4,234,162,262,100
Female,330,565,76,184,21٫28,242,160,270,110
Female,330,566,75,180,21,244,153,245,92
Female,330,573,83,197,23٫24,244,164,272,108
Female,330,580,81,189,22٫68,253,154,271,117
Female,330,583,76,187,21٫28,245,154,267,113
Female,330,585,77,183,21٫56,249,152,260,108
Female,330,585,78,193,21٫84,251,153,256,103
Female,330,585,80,193,22٫4,242,162,282,120
Female,330,590,80,186,22٫4,242,154,247,93
Female,330,590,83,193,23٫24,246,164,274,110
Female,330,591,75,177,21,250,149,247,98
Female,330,594,79,187,22٫12,246,153,260,107
Female,330,597,77,187,21٫56,249,148,246,98
Female,330,601,78,187,21٫84,250,159,260,101
Female,330,604,72,182,20٫16,252,150,247,97
Female,330,604,77,185,21٫56,241,154,257,103
Female,330,604,78,189,21٫84,250,156,260,104
Female,330,605,78,193,21٫84,245,156,258,102
Female,330,608,81,190,22٫68,257,160,284,124
Female,330,609,79,190,22٫12,253,156,268,112
Female,330,611,76,184,21٫28,251,152,264,112
Female,330,611,85,196,23٫8,259,153,266,113
Female,330,615,79,187,22٫12,254,154,275,121
Female,330,615,80,187,22٫4,259,161,265,104
Female,330,624,80,184,22٫4,259,146,238,92
Female,330,625,76,185,21٫28,262,150,272,122
Female,331,560,81,187,22٫68,241,150,262,112
Female,331,565,83,194,23٫24,243,160,279,119
Female,331,566,79,195,22٫12,239,162,273,111
Female,331,571,82,191,22٫96,238,154,263,109
Female,331,572,80,178,22٫4,250,153,262,109
Female,331,573,81,187,22٫68,255,155,280,125
Female,331,583,77,188,21٫56,243,150,280,130
Female,331,588,75,189,21,256,161,287,126
Female,331,590,80,189,22٫4,255,155,254,99
Female,331,592,79,188,22٫12,244,157,286,129
Female,331,594,78,187,21٫84,252,159,271,112
Female,331,595,78,187,21٫84,251,154,286,132
Female,331,596,77,185,21٫56,254,147,241,94
Female,331,597,77,187,21٫56,249,149,252,103
Female,331,600,76,187,21٫28,250,155,284,129
Female,331,603,84,197,23٫52,260,155,274,119
Female,331,605,80,192,22٫4,255,160,266,106
Female,331,605,81,187,22٫68,250,153,254,101
Female,331,605,85,198,23٫8,267,164,293,129
Female,331,607,80,187,22٫4,246,154,275,121
Female,331,610,82,189,22٫96,252,158,273,115
Female,331,613,82,193,22٫96,258,163,296,133
Female,331,617,80,190,22٫4,259,165,283,118
Female,332,566,78,186,21٫84,245,149,255,106
Female,332,572,81,187,22٫68,247,162,275,113
Female,332,582,82,202,22٫96,247,159,273,114
Female,332,589,78,183,21٫84,256,147,240,93
Female,332,590,79,185,22٫12,245,151,277,126
Female,332,594,75,177,21,248,155,251,96
Female,332,595,82,197,22٫96,261,151,266,115
Female,332,596,83,191,23٫24,247,159,286,127
Female,332,597,78,189,21٫84,264,167,296,129
Female,332,601,80,187,22٫4,268,155,269,114
Female,332,604,77,185,21٫56,257,145,250,105
Female,332,608,84,191,23٫52,254,163,262,99
Female,332,609,76,194,21٫28,252,162,269,107
Female,332,609,78,184,21٫84,259,159,279,120
Female,332,611,74,182,20٫72,254,151,264,113
Female,332,626,77,193,21٫56,262,148,278,130
Female,333,578,80,187,22٫4,262,153,256,103
Female,333,579,81,197,22٫68,251,158,269,111
Female,333,581,79,191,22٫12,244,162,273,111
Female,333,584,78,182,21٫84,246,147,238,91
Female,333,590,82,201,22٫96,256,162,288,126
Female,333,592,80,189,22٫4,253,153,247,94
Female,333,595,77,190,21٫56,251,165,290,125
Female,333,601,76,182,21٫28,255,155,267,112
Female,333,601,79,186,22٫12,254,151,247,96
Female,333,602,81,193,22٫68,253,156,278,122
Female,333,607,77,194,21٫56,248,157,271,114
Female,333,609,77,180,21٫56,252,149,241,92
Female,333,610,84,195,23٫52,260,162,274,112
Female,333,612,74,182,20٫72,254,158,277,119
Female,333,616,78,184,21٫84,265,150,259,109
Female,333,616,82,193,22٫96,258,153,246,93
Female,333,617,80,193,22٫4,255,161,279,118
Female,333,620,80,200,22٫4,261,157,278,121
Female,333,622,84,202,23٫52,268,165,272,107
Female,334,572,77,178,21٫56,238,150,252,102
Female,334,577,73,173,20٫44,245,148,254,106
Female,334,586,75,179,21,252,158,267,109
Female,334,588,80,189,22٫4,259,147,251,104
Female,334,589,78,190,21٫84,243,164,272,108
Female,334,595,77,187,21٫56,253,162,292,130
Female,334,596,81,190,22٫68,262,157,277,120
Female,334,596,84,198,23٫52,254,163,274,111
Female,334,597,74,191,20٫72,251,152,264,112
Female,334,599,75,183,21,260,166,271,105
Female,334,606,80,194,22٫4,252,153,263,110
Female,334,607,79,190,22٫12,250,164,260,96
Female,334,609,80,197,22٫4,262,161,282,121
Female,334,610,78,188,21٫84,260,148,258,110
Female,335,576,84,202,23٫52,261,164,262,98
Female,335,584,83,200,23٫24,244,156,270,114
Female,335,587,82,194,22٫96,245,154,278,124
Female,335,589,78,189,21٫84,248,157,282,125
Female,335,589,79,194,22٫12,259,161,284,123
Female,335,590,84,195,23٫52,248,163,288,125
Female,335,595,84,195,23٫52,261,155,253,98
Female,335,598,78,189,21٫84,260,154,246,92
Female,335,600,81,187,22٫68,241,155,271,116
Female,335,601,77,188,21٫56,251,154,267,113
Female,335,601,80,188,22٫4,245,165,287,122
Female,335,604,73,179,20٫44,259,149,252,103
Female,335,606,80,195,22٫4,261,160,259,99
Female,335,611,84,200,23٫52,259,157,290,133
Female,335,613,76,182,21٫28,249,148,255,107
Female,335,613,77,189,21٫56,256,149,262,113
Female,335,615,77,190,21٫56,260,160,294,134
Female,335,615,80,196,22٫4,261,167,274,107
Female,335,616,78,190,21٫84,260,150,261,111
Female,335,619,80,194,22٫4,258,165,276,111
Female,336,568,79,189,22٫12,244,151,257,106
Female,336,581,83,193,23٫24,253,157,268,111
Female,336,582,77,188,21٫56,243,155,273,118
Female,336,582,82,197,22٫96,262,167,290,123
Female,336,585,82,193,22٫96,257,165,266,101
Female,336,589,81,193,22٫68,244,152,262,110
Female,336,601,74,177,20٫72,258,148,242,94
Female,336,601,78,187,21٫84,258,149,247,98
Female,336,601,78,187,21٫84,263,150,249,99
Female,336,601,79,189,22٫12,265,153,252,99
Female,336,601,80,191,22٫4,257,156,280,124
Female,336,603,80,183,22٫4,252,153,252,99
Female,336,605,78,196,21٫84,258,154,258,104
Female,336,605,82,192,22٫96,255,157,271,114
Female,336,606,79,181,22٫12,255,150,260,110
Female,336,610,85,198,23٫8,258,160,267,107
Female,336,618,77,185,21٫56,265,155,272,117
Female,337,569,76,190,21٫28,246,160,268,108
Female,337,579,74,181,20٫72,255,156,276,120
Female,337,582,79,187,22٫12,246,158,292,134
Female,337,588,79,183,22٫12,254,154,252,98
Female,337,595,81,194,22٫68,257,151,256,105
Female,337,608,76,183,21٫28,250,154,266,112
Female,337,610,78,187,21٫84,252,155,245,90
Female,337,612,81,188,22٫68,254,157,265,108
Female,337,615,79,189,22٫12,252,153,261,108
Female,337,616,82,197,22٫96,255,165,287,122
Female,338,579,76,178,21٫28,249,150,279,129
Female,338,590,74,182,20٫72,256,154,287,133
Female,338,592,81,193,22٫68,259,167,296,129
Female,338,597,82,192,22٫96,259,159,288,129
Female,338,599,80,183,22٫4,251,155,271,116
Female,338,601,83,198,23٫24,254,160,288,128
Female,338,602,76,188,21٫28,262,164,291,127
Female,338,604,82,195,22٫96,262,165,270,105
Female,338,611,80,193,22٫4,262,153,283,130
Female,338,611,84,190,23٫52,265,156,275,119
Female,338,613,80,193,22٫4,264,162,278,116
Female,338,617,82,194,22٫96,251,160,273,113
Female,338,620,78,187,21٫84,257,165,270,105
Female,338,622,83,197,23٫24,264,163,293,130
Female,339,571,78,183,21٫84,242,152,260,108
Female,339,581,77,191,21٫56,257,154,263,109
Female,339,595,78,188,21٫84,243,158,261,103
Female,339,597,81,200,22٫68,247,161,280,119
Female,339,598,78,192,21٫84,251,160,260,100
Female,339,598,79,185,22٫12,255,156,274,118
Female,339,606,83,192,23٫24,254,161,276,115
Female,339,607,79,188,22٫12,252,160,273,113
Female,339,608,78,187,21٫84,260,151,265,114
Female,339,612,82,187,22٫96,262,161,271,110
Female,339,615,84,201,23٫52,260,158,267,109
Female,339,622,84,197,23٫52,254,165,288,123
Female,339,624,83,192,23٫24,260,162,261,99
Female,340,584,80,190,22٫4,246,162,254,92
Female,340,586,80,188,22٫4,258,155,274,119
Female,340,589,79,190,22٫12,259,152,257,105
Female,340,590,79,186,22٫12,257,158,279,121
Female,340,593,80,195,22٫4,251,165,272,107
Female,340,603,79,185,22٫12,252,167,270,103
Female,340,603,81,193,22٫68,261,160,271,111
Female,340,609,77,186,21٫56,264,153,279,126
Female,340,611,83,191,23٫24,264,165,269,104
Female,340,616,76,183,21٫28,258,160,256,96
Female,340,616,82,193,22٫96,264,166,276,110
Female,340,622,76,182,21٫28,254,156,272,116
Female,340,623,80,187,22٫4,255,158,277,119
Female,340,626,82,197,22٫96,264,161,266,105
Female,341,585,80,197,22٫4,250,166,274,108
Female,341,590,75,184,21,251,152,257,105
Female,341,594,81,198,22٫68,261,159,282,123
Female,341,595,82,198,22٫96,259,167,295,128
Female,341,599,79,184,22٫12,254,155,255,100
Female,341,605,78,187,21٫84,259,155,247,92
Female,341,609,74,176,20٫72,262,147,236,89
Female,341,611,78,187,21٫84,256,153,256,103
Female,341,615,82,192,22٫96,265,162,285,123
Female,341,618,79,193,22٫12,262,152,254,102
Female,341,621,80,192,22٫4,257,167,267,100
Female,341,625,78,191,21٫84,266,158,273,115
Female,342,592,80,191,22٫4,254,160,263,103
Female,342,598,80,188,22٫4,252,159,280,121
Female,342,599,75,183,21,255,156,252,96
Female,342,604,80,197,22٫4,253,164,266,102
Female,342,624,78,184,21٫84,266,154,245,91
Female,343,590,82,195,22٫96,249,147,245,98
Female,343,600,76,188,21٫28,254,159,252,93
Female,343,602,80,197,22٫4,267,161,275,114
Female,343,609,85,197,23٫8,253,161,281,120
Female,343,620,84,198,23٫52,258,162,262,100
Female,344,586,84,198,23٫52,254,165,280,115
Female,344,593,80,186,22٫4,256,157,287,130
Female,344,600,75,183,21,255,144,244,100
Female,344,603,85,198,23٫8,254,155,277,122
Female,344,621,80,195,22٫4,258,163,280,117
Female,344,621,81,196,22٫68,264,165,280,115
Female,344,623,83,201,23٫24,261,164,271,107
Female,345,599,81,192,22٫68,259,166,270,104
Female,345,606,75,178,21,252,149,270,121
Female,345,619,79,193,22٫12,259,157,281,124
Female,345,619,81,190,22٫68,267,156,283,127
Female,346,594,80,197,22٫4,258,157,270,113
Female,346,608,76,190,21٫28,264,164,282,118
Female,346,615,80,192,22٫4,265,157,257,100
Female,346,618,79,195,22٫12,267,154,256,102
Female,346,618,80,189,22٫4,263,162,255,93
Female,346,622,82,197,22٫96,265,163,270,107
Female,346,625,80,193,22٫4,261,164,281,117
Female,347,602,81,191,22٫68,264,162,276,114
Female,347,613,85,198,23٫8,268,158,266,108
Female,347,618,74,184,20٫72,261,154,261,107
Female,347,622,76,190,21٫28,261,162,285,123
Female,348,594,78,179,21٫84,250,159,262,103
Female,348,604,80,190,22٫4,267,164,292,128
Female,348,617,80,191,22٫4,266,166,273,107
Female,348,618,83,200,23٫24,261,168,278,110
Female,348,620,85,196,23٫8,258,160,269,109
Female,349,607,79,192,22٫12,262,157,263,106
Female,349,613,83,194,23٫24,267,162,272,110
Female,349,614,81,189,22٫68,263,153,275,122
Female,350,606,83,197,23٫24,268,162,279,117
Female,350,624,82,197,22٫96,267,156,279,123
Female,350,627,76,185,21٫28,265,152,250,98