Gender,forearmcenterofgriplength,elbow_wrist_length,handbreadth,handcircumference,thumbbreadth_estimated,radialestylionlength,wristcircumference,forearmcircumferenceflexed,forearm_taper_diff
Male,320,585,81,198,22٫68,246,164,290,126
Male,320,588,91,218,25٫48,250,170,288,118
Male,320,590,88,210,24٫64,246,170,278,108
Male,320,597,87,210,24٫36,253,164,291,127
Male,320,600,82,201,22٫96,252,168,290,122
Male,320,602,88,212,24٫64,248,165,312,147
Male,320,604,83,200,23٫24,254,166,290,124
Male,320,606,84,214,23٫52,252,175,323,148
Male,320,610,96,227,26٫88,255,187,319,132
Male,320,611,88,210,24٫64,252,170,292,122
Male,320,615,91,218,25٫48,254,172,294,122
Male,320,624,95,225,26٫6,258,180,293,113
Male,321,583,85,200,23٫8,246,163,298,135
Male,321,585,89,216,24٫92,248,167,305,138
Male,321,586,84,206,23٫52,244,171,309,138
Male,321,588,83,202,23٫24,249,170,294,124
Male,321,588,85,206,23٫8,250,167,282,115
Male,321,589,86,206,24٫08,253,171,293,122
Male,321,589,87,208,24٫36,246,164,280,116
Male,321,589,87,216,24٫36,247,174,314,140
Male,321,590,84,204,23٫52,246,165,284,119
Male,321,600,81,198,22٫68,250,165,291,126
Male,321,601,90,217,25٫2,247,175,307,132
Male,321,604,84,207,23٫52,244,174,301,127
Male,321,625,89,212,24٫92,254,170,311,141
Male,322,584,84,197,23٫52,245,169,309,140
Male,322,585,86,211,24٫08,251,172,315,143
Male,322,585,89,214,24٫92,245,165,296,131
Male,322,588,87,206,24٫36,254,171,293,122
Male,322,589,86,210,24٫08,248,173,313,140
Male,322,590,85,205,23٫8,250,170,280,110
Male,322,590,86,201,24٫08,244,162,290,128
Male,322,597,91,217,25٫48,246,167,298,131
Male,322,597,91,225,25٫48,248,187,336,149
Male,322,599,83,197,23٫24,254,167,301,134
Male,322,602,83,200,23٫24,249,170,301,131
Male,322,610,86,213,24٫08,256,176,307,131
Male,322,612,92,218,25٫76,254,172,299,127
Male,322,616,84,205,23٫52,257,171,294,123
Male,323,587,81,197,22٫68,250,163,290,127
Male,323,589,88,208,24٫64,252,172,304,132
Male,323,589,88,210,24٫64,246,167,295,128
Male,323,590,81,196,22٫68,256,167,286,119
Male,323,598,93,223,26٫04,247,187,314,127
Male,323,600,87,208,24٫36,249,171,291,120
Male,323,600,88,211,24٫64,255,172,291,119
Male,323,602,88,206,24٫64,256,163,275,112
Male,323,603,87,208,24٫36,257,169,290,121
Male,323,605,84,211,23٫52,252,186,323,137
Male,323,605,92,217,25٫76,244,173,305,132
Male,323,606,82,198,22٫96,244,165,295,130
Male,323,607,90,213,25٫2,250,174,292,118
Male,323,610,86,207,24٫08,255,167,311,144
Male,323,615,86,205,24٫08,252,171,289,118
Male,324,581,83,199,23٫24,246,162,303,141
Male,324,584,83,197,23٫24,248,170,286,116
Male,324,584,85,207,23٫8,249,173,321,148
Male,324,584,93,216,26٫04,253,174,334,160
Male,324,588,94,222,26٫32,244,181,309,128
Male,324,590,81,200,22٫68,252,166,287,121
Male,324,592,86,206,24٫08,244,165,295,130
Male,324,595,88,210,24٫64,251,180,300,120
Male,324,599,86,209,24٫08,252,171,312,141
Male,324,599,94,223,26٫32,245,180,314,134
Male,324,600,95,223,26٫6,253,177,301,124
Male,324,603,87,207,24٫36,248,168,304,136
Male,324,604,87,216,24٫36,262,172,322,150
Male,324,604,92,214,25٫76,265,182,298,116
Male,324,605,85,204,23٫8,254,164,284,120
Male,324,606,84,206,23٫52,251,169,285,116
Male,324,606,87,206,24٫36,255,171,282,111
Male,324,612,86,205,24٫08,245,173,304,131
Male,324,612,90,213,25٫2,255,178,322,144
Male,324,633,91,215,25٫48,266,188,339,151
Male,325,583,89,211,24٫92,252,168,308,140
Male,325,586,90,217,25٫2,249,174,300,126
Male,325,588,83,202,23٫24,255,165,283,118
Male,325,589,83,202,23٫24,249,168,304,136
Male,325,590,81,197,22٫68,252,171,288,117
Male,325,595,89,218,24٫92,255,172,310,138
Male,325,597,86,206,24٫08,254,170,331,161
Male,325,598,87,211,24٫36,255,171,318,147
Male,325,602,89,215,24٫92,253,183,310,127
Male,325,602,90,218,25٫2,254,168,299,131
Male,325,603,90,211,25٫2,252,172,313,141
Male,325,603,90,215,25٫2,248,164,312,148
Male,325,604,84,207,23٫52,261,174,288,114
Male,325,611,82,206,22٫96,255,172,318,146
Male,325,613,88,209,24٫64,257,166,301,135
Male,325,616,85,198,23٫8,259,167,293,126
Male,325,619,89,211,24٫92,265,162,283,121
Male,325,620,87,208,24٫36,253,167,302,135
Male,325,622,89,217,24٫92,263,163,275,112
Male,326,581,82,195,22٫96,250,162,304,142
Male,326,581,86,207,24٫08,245,177,337,160
Male,326,583,90,214,25٫2,256,179,300,121
Male,326,585,85,207,23٫8,247,167,307,140
Male,326,587,82,198,22٫96,248,170,292,122
Male,326,590,84,203,23٫52,251,162,296,134
Male,326,592,88,210,24٫64,248,175,287,112
Male,326,595,85,202,23٫8,252,170,308,138
Male,326,596,81,206,22٫68,257,169,317,148
Male,326,597,85,202,23٫8,255,167,286,119
Male,326,599,89,209,24٫92,253,167,320,153
Male,326,600,86,205,24٫08,250,179,311,132
Male,326,602,85,202,23٫8,256,170,302,132
Male,326,603,90,208,25٫2,254,177,288,111
Male,326,603,93,220,26٫04,252,178,328,150
Male,326,604,89,215,24٫92,251,175,312,137
Male,326,608,87,205,24٫36,262,169,303,134
Male,326,609,84,207,23٫52,251,180,314,134
Male,326,609,86,208,24٫08,247,165,279,114
Male,326,613,87,214,24٫36,257,187,345,158
Male,326,616,85,202,23٫8,253,170,309,139
Male,327,583,84,211,23٫52,247,173,332,159
Male,327,583,95,227,26٫6,247,185,343,158
Male,327,586,84,204,23٫52,248,173,302,129
Male,327,588,86,209,24٫08,251,177,309,132
Male,327,591,88,207,24٫64,244,169,284,115
Male,327,592,82,200,22٫96,248,178,333,155
Male,327,592,88,210,24٫64,251,175,330,155
Male,327,592,88,221,24٫64,246,183,322,139
Male,327,593,86,204,24٫08,252,173,303,130
Male,327,593,90,216,25٫2,246,174,310,136
Male,327,594,81,202,22٫68,247,168,297,129
Male,327,594,86,210,24٫08,252,183,292,109
Male,327,595,83,204,23٫24,251,164,285,121
Male,327,595,84,202,23٫52,253,178,310,132
Male,327,595,90,213,25٫2,249,174,316,142
Male,327,595,90,216,25٫2,246,181,320,139
Male,327,597,86,204,24٫08,247,164,310,146
Male,327,599,86,206,24٫08,259,173,303,130
Male,327,599,88,210,24٫64,253,171,299,128
Male,327,600,87,204,24٫36,249,177,291,114
Male,327,600,90,218,25٫2,252,178,315,137
Male,327,600,91,221,25٫48,259,174,331,157
Male,327,602,90,213,25٫2,245,167,318,151
Male,327,603,84,197,23٫52,258,163,288,125
Male,327,603,96,226,26٫88,250,182,317,135
Male,327,604,88,214,24٫64,250,182,334,152
Male,327,604,92,222,25٫76,269,178,338,160
Male,327,605,85,206,23٫8,247,171,300,129
Male,327,606,82,206,22٫96,250,167,297,130
Male,327,606,88,209,24٫64,259,175,318,143
Male,327,609,86,207,24٫08,258,173,302,129
Male,327,615,89,211,24٫92,258,187,326,139
Male,327,616,85,199,23٫8,262,173,320,147
Male,327,616,87,213,24٫36,253,177,300,123
Male,327,617,82,201,22٫96,262,162,287,125
Male,327,637,90,217,25٫2,276,180,323,143
Male,327,645,93,222,26٫04,263,177,327,150
Male,328,582,87,213,24٫36,246,174,310,136
Male,328,589,86,209,24٫08,250,164,320,156
Male,328,590,83,204,23٫24,248,170,292,122
Male,328,590,86,208,24٫08,245,172,311,139
Male,328,591,87,211,24٫36,257,174,304,130
Male,328,592,90,206,25٫2,261,164,291,127
Male,328,593,82,198,22٫96,249,172,298,126
Male,328,593,84,203,23٫52,249,178,303,125
Male,328,593,87,213,24٫36,245,168,297,129
Male,328,595,90,213,25٫2,248,171,291,120
Male,328,596,85,208,23٫8,255,174,315,141
Male,328,598,87,205,24٫36,249,170,322,152
Male,328,598,88,214,24٫64,254,173,298,125
Male,328,600,81,203,22٫68,251,177,312,135
Male,328,600,82,202,22٫96,255,165,294,129
Male,328,601,87,212,24٫36,254,170,320,150
Male,328,603,85,203,23٫8,257,170,282,112
Male,328,604,84,204,23٫52,246,174,323,149
Male,328,604,90,215,25٫2,257,176,300,124
Male,328,605,84,206,23٫52,256,166,303,137
Male,328,610,89,215,24٫92,252,168,303,135
Male,328,613,87,208,24٫36,250,184,325,141
Male,328,614,87,202,24٫36,261,170,280,110
Male,328,616,89,214,24٫92,250,168,293,125
Male,328,617,85,201,23٫8,264,171,281,110
Male,328,623,88,211,24٫64,268,184,344,160
Male,328,637,82,202,22٫96,274,168,286,118
Male,329,581,87,217,24٫36,247,180,310,130
Male,329,582,85,202,23٫8,251,175,303,128
Male,329,587,86,204,24٫08,246,180,297,117
Male,329,587,87,208,24٫36,245,172,301,129
Male,329,594,85,199,23٫8,250,162,281,119
Male,329,595,85,202,23٫8,261,166,298,132
Male,329,596,81,198,22٫68,252,171,295,124
Male,329,596,85,202,23٫8,253,171,310,139
Male,329,596,88,210,24٫64,245,181,337,156
Male,329,596,90,212,25٫2,246,183,322,139
Male,329,599,83,200,23٫24,261,164,297,133
Male,329,600,85,206,23٫8,251,177,313,136
Male,329,600,85,209,23٫8,250,168,280,112
Male,329,600,88,209,24٫64,249,183,336,153
Male,329,602,86,205,24٫08,258,170,285,115
Male,329,603,90,216,25٫2,246,178,332,154
Male,329,604,93,223,26٫04,250,182,326,144
Male,329,607,94,223,26٫32,260,190,337,147
Male,329,609,89,216,24٫92,259,176,318,142
Male,329,611,84,201,23٫52,251,164,285,121
Male,329,616,87,212,24٫36,252,173,298,125
Male,329,616,90,213,25٫2,262,167,310,143
Male,329,620,94,225,26٫32,257,179,309,130
Male,329,622,85,200,23٫8,262,167,294,127
Male,329,640,89,213,24٫92,273,171,290,119
Male,330,581,87,203,24٫36,244,168,291,123
Male,330,584,94,225,26٫32,252,181,320,139
Male,330,585,82,197,22٫96,251,163,281,118
Male,330,585,91,213,25٫48,246,173,318,145
Male,330,585,92,223,25٫76,251,182,321,139
Male,330,587,88,213,24٫64,250,176,308,132
Male,330,591,87,208,24٫36,244,170,311,141
Male,330,595,86,210,24٫08,245,175,305,130
Male,330,596,87,208,24٫36,258,173,310,137
Male,330,599,82,199,22٫96,246,164,275,111
Male,330,600,86,206,24٫08,259,169,327,158
Male,330,602,87,212,24٫36,251,169,308,139
Male,330,603,87,212,24٫36,258,175,297,122
Male,330,603,89,211,24٫92,249,175,315,140
Male,330,604,83,200,23٫24,257,167,315,148
Male,330,604,86,203,24٫08,251,168,305,137
Male,330,604,91,219,25٫48,247,179,315,136
Male,330,604,93,218,26٫04,250,178,316,138
Male,330,605,82,195,22٫96,261,169,287,118
Male,330,606,83,203,23٫24,264,164,278,114
Male,330,606,85,209,23٫8,254,170,307,137
Male,330,606,86,208,24٫08,257,176,314,138
Male,330,606,87,207,24٫36,255,173,297,124
Male,330,607,92,227,25٫76,256,190,332,142
Male,330,608,87,211,24٫36,250,174,310,136
Male,330,609,88,212,24٫64,262,174,312,138
Male,330,610,90,212,25٫2,259,176,331,155
Male,330,610,91,221,25٫48,253,180,295,115
Male,330,611,86,207,24٫08,252,172,297,125
Male,330,611,89,213,24٫92,254,183,300,117
Male,330,611,89,213,24٫92,257,189,330,141
Male,330,617,90,215,25٫2,261,178,305,127
Male,330,618,81,200,22٫68,260,164,291,127
Male,330,620,81,196,22٫68,260,168,305,137
Male,330,621,87,209,24٫36,260,178,315,137
Male,330,621,90,216,25٫2,259,177,319,142
Male,330,622,92,225,25٫76,260,180,315,135
Male,330,623,92,216,25٫76,260,174,311,137
Male,330,629,87,210,24٫36,266,169,304,135
Male,330,630,85,205,23٫8,262,168,293,125
Male,330,637,88,214,24٫64,254,176,325,149
Male,330,638,89,211,24٫92,268,170,280,110
Male,331,582,85,204,23٫8,244,176,293,117
Male,331,583,81,206,22٫68,248,171,328,157
Male,331,583,87,207,24٫36,247,185,318,133
Male,331,584,86,212,24٫08,249,168,300,132
Male,331,586,87,211,24٫36,247,174,298,124
Male,331,586,88,206,24٫64,254,172,299,127
Male,331,588,87,208,24٫36,251,174,315,141
Male,331,589,87,212,24٫36,244,175,296,121
Male,331,589,88,212,24٫64,248,169,283,114
Male,331,590,88,216,24٫64,244,184,333,149
Male,331,592,89,215,24٫92,251,176,320,144
Male,331,593,84,207,23٫52,247,172,305,133
Male,331,593,90,223,25٫2,248,181,324,143
Male,331,594,84,197,23٫52,260,167,295,128
Male,331,595,87,208,24٫36,248,174,308,134
Male,331,595,88,210,24٫64,262,176,323,147
Male,331,597,81,196,22٫68,253,162,277,115
Male,331,597,84,207,23٫52,247,167,281,114
Male,331,597,87,210,24٫36,252,176,320,144
Male,331,598,85,200,23٫8,252,170,302,132
Male,331,598,87,208,24٫36,254,170,307,137
Male,331,600,88,216,24٫64,246,175,324,149
Male,331,600,91,215,25٫48,249,183,332,149
Male,331,601,83,198,23٫24,251,167,289,122
Male,331,602,86,200,24٫08,256,169,323,154
Male,331,602,91,216,25٫48,248,186,312,126
Male,331,603,85,202,23٫8,254,174,324,150
Male,331,603,87,208,24٫36,258,176,291,115
Male,331,607,84,201,23٫52,266,163,308,145
Male,331,607,85,201,23٫8,248,172,325,153
Male,331,608,90,216,25٫2,259,166,315,149
Male,331,610,84,201,23٫52,254,167,293,126
Male,331,611,92,218,25٫76,265,182,337,155
Male,331,614,84,200,23٫52,257,165,293,128
Male,331,614,89,222,24٫92,257,166,303,137
Male,331,615,84,204,23٫52,258,168,312,144
Male,331,616,81,195,22٫68,255,166,291,125
Male,331,616,82,199,22٫96,260,165,320,155
Male,331,616,86,207,24٫08,270,166,304,138
Male,331,618,85,205,23٫8,266,174,285,111
Male,331,618,87,212,24٫36,259,181,308,127
Male,331,618,95,226,26٫6,259,189,324,135
Male,331,619,84,202,23٫52,257,165,292,127
Male,331,620,87,208,24٫36,256,180,320,140
Male,331,622,89,210,24٫92,255,176,311,135
Male,331,623,82,200,22٫96,260,172,308,136
Male,331,624,88,210,24٫64,260,168,308,140
Male,331,626,90,214,25٫2,262,177,312,135
Male,331,627,87,203,24٫36,261,173,308,135
Male,331,628,85,207,23٫8,260,181,327,146
Male,332,581,91,219,25٫48,250,173,291,118
Male,332,587,85,201,23٫8,254,169,304,135
Male,332,588,89,218,24٫92,251,186,304,118
Male,332,590,88,205,24٫64,250,163,301,138
Male,332,592,94,223,26٫32,249,184,329,145
Male,332,597,91,214,25٫48,255,164,275,111
Male,332,600,83,199,23٫24,248,171,289,118
Male,332,601,88,218,24٫64,252,172,303,131
Male,332,603,85,209,23٫8,257,171,292,121
Male,332,605,84,205,23٫52,251,175,323,148
Male,332,608,87,215,24٫36,255,178,317,139
Male,332,608,88,210,24٫64,255,166,276,110
Male,332,608,90,210,25٫2,267,180,334,154
Male,332,610,81,200,22٫68,254,169,301,132
Male,332,610,82,203,22٫96,255,171,314,143
Male,332,610,87,210,24٫36,264,166,275,109
Male,332,610,88,212,24٫64,263,175,312,137
Male,332,612,87,208,24٫36,253,167,295,128
Male,332,613,84,197,23٫52,252,170,310,140
Male,332,613,87,217,24٫36,253,174,308,134
Male,332,614,85,203,23٫8,257,174,312,138
Male,332,616,88,208,24٫64,256,178,332,154
Male,332,618,90,210,25٫2,260,175,305,130
Male,332,621,85,205,23٫8,266,163,287,124
Male,332,621,87,211,24٫36,259,166,286,120
Male,332,621,87,211,24٫36,266,181,298,117
Male,332,622,87,211,24٫36,258,169,296,127
Male,332,623,90,213,25٫2,256,171,305,134
Male,332,624,87,212,24٫36,258,177,291,114
Male,332,625,90,212,25٫2,267,166,302,136
Male,332,626,85,205,23٫8,265,173,288,115
Male,332,628,88,207,24٫64,263,168,295,127
Male,332,629,85,201,23٫8,257,175,302,127
Male,332,629,87,211,24٫36,253,178,317,139
Male,332,635,83,197,23٫24,265,169,282,113
Male,332,636,84,198,23٫52,265,168,278,110
Male,333,582,87,215,24٫36,256,177,321,144
Male,333,586,93,219,26٫04,248,179,315,136
Male,333,588,89,213,24٫92,244,180,298,118
Male,333,588,93,220,26٫04,253,180,336,156
Male,333,589,84,204,23٫52,249,170,313,143
Male,333,591,87,204,24٫36,246,165,295,130
Male,333,592,88,212,24٫64,251,168,283,115
Male,333,595,90,214,25٫2,257,172,317,145
Male,333,596,86,214,24٫08,250,172,323,151
Male,333,599,89,211,24٫92,253,180,306,126
Male,333,599,90,216,25٫2,260,179,302,123
Male,333,600,87,207,24٫36,250,174,302,128
Male,333,601,88,215,24٫64,258,177,310,133
Male,333,601,90,213,25٫2,256,178,308,130
Male,333,604,81,201,22٫68,254,167,301,134
Male,333,604,88,214,24٫64,258,178,300,122
Male,333,605,86,210,24٫08,259,172,300,128
Male,333,605,93,218,26٫04,256,173,314,141
Male,333,607,87,213,24٫36,260,175,299,124
Male,333,608,85,204,23٫8,254,180,308,128
Male,333,608,94,227,26٫32,264,176,331,155
Male,333,609,87,206,24٫36,258,173,295,122
Male,333,609,92,224,25٫76,252,181,333,152
Male,333,610,84,201,23٫52,257,168,278,110
Male,333,611,90,212,25٫2,258,177,306,129
Male,333,612,84,207,23٫52,260,167,291,124
Male,333,612,86,213,24٫08,261,173,306,133
Male,333,612,88,212,24٫64,257,165,297,132
Male,333,613,87,206,24٫36,255,177,332,155
Male,333,613,88,217,24٫64,254,171,292,121
Male,333,615,82,202,22٫96,260,168,304,136
Male,333,615,86,206,24٫08,250,166,285,119
Male,333,615,87,203,24٫36,263,170,328,158
Male,333,615,92,225,25٫76,267,179,307,128
Male,333,617,85,208,23٫8,266,171,304,133
Male,333,618,88,213,24٫64,267,176,293,117
Male,333,618,90,219,25٫2,263,180,319,139
Male,333,619,88,216,24٫64,257,174,299,125
Male,333,619,90,215,25٫2,257,172,313,141
Male,333,621,84,210,23٫52,259,165,293,128
Male,333,622,86,205,24٫08,266,170,301,131
Male,333,623,93,223,26٫04,260,187,332,145
Male,333,625,84,197,23٫52,258,169,306,137
Male,333,625,87,205,24٫36,262,163,283,120
Male,333,626,92,220,25٫76,272,191,315,124
Male,333,627,86,201,24٫08,271,168,305,137
Male,333,628,89,217,24٫92,259,174,312,138
Male,333,633,86,203,24٫08,270,164,280,116
Male,333,638,86,204,24٫08,264,170,296,126
Male,334,582,85,217,23٫8,257,173,293,120
Male,334,584,83,208,23٫24,246,170,316,146
Male,334,584,84,200,23٫52,250,174,306,132
Male,334,589,84,200,23٫52,255,165,300,135
Male,334,591,86,203,24٫08,246,164,280,116
Male,334,591,90,210,25٫2,244,166,302,136
Male,334,597,91,219,25٫48,255,178,305,127
Male,334,599,93,221,26٫04,249,172,317,145
Male,334,600,87,207,24٫36,260,172,306,134
Male,334,600,87,208,24٫36,264,170,285,115
Male,334,603,89,214,24٫92,252,191,327,136
Male,334,605,83,203,23٫24,263,173,313,140
Male,334,605,84,203,23٫52,263,165,314,149
Male,334,605,85,198,23٫8,254,176,303,127
Male,334,605,87,207,24٫36,250,173,295,122
Male,334,605,90,215,25٫2,257,174,319,145
Male,334,606,84,202,23٫52,259,167,296,129
Male,334,606,89,212,24٫92,265,176,303,127
Male,334,606,90,210,25٫2,248,184,314,130
Male,334,606,90,213,25٫2,251,173,329,156
Male,334,608,88,212,24٫64,253,177,290,113
Male,334,608,92,217,25٫76,251,173,297,124
Male,334,608,93,222,26٫04,256,175,317,142
Male,334,610,91,219,25٫48,269,174,302,128
Male,334,611,88,203,24٫64,251,184,319,135
Male,334,611,89,217,24٫92,256,172,334,162
Male,334,611,90,209,25٫2,259,170,302,132
Male,334,612,85,211,23٫8,252,178,295,117
Male,334,612,90,211,25٫2,265,179,326,147
Male,334,613,90,211,25٫2,254,174,292,118
Male,334,614,83,201,23٫24,258,168,285,117
Male,334,614,85,213,23٫8,261,173,287,114
Male,334,615,81,203,22٫68,248,169,298,129
Male,334,615,84,204,23٫52,259,170,290,120
Male,334,615,85,205,23٫8,257,176,296,120
Male,334,617,83,196,23٫24,264,166,298,132
Male,334,619,81,198,22٫68,254,164,293,129
Male,334,622,84,207,23٫52,257,169,292,123
Male,334,623,89,206,24٫92,264,164,296,132
Male,334,623,90,209,25٫2,251,182,295,113
Male,334,624,83,198,23٫24,263,174,285,111
Male,334,625,86,214,24٫08,261,173,331,158
Male,334,625,92,221,25٫76,249,177,317,140
Male,334,625,93,228,26٫04,253,187,325,138
Male,334,629,88,211,24٫64,266,173,295,122
Male,334,631,90,217,25٫2,263,180,325,145
Male,334,632,91,218,25٫48,263,168,289,121
Male,334,633,82,202,22٫96,263,176,294,118
Male,334,635,88,212,24٫64,269,176,292,116
Male,334,646,86,202,24٫08,268,165,286,121
Male,335,581,91,217,25٫48,251,178,329,151
Male,335,586,85,204,23٫8,246,175,296,121
Male,335,589,85,215,23٫8,252,173,315,142
Male,335,596,93,222,26٫04,251,181,319,138
Male,335,598,93,225,26٫04,252,176,325,149
Male,335,600,84,212,23٫52,256,172,321,149
Male,335,601,84,203,23٫52,250,169,300,131
Male,335,601,84,203,23٫52,254,165,284,119
Male,335,601,87,202,24٫36,256,172,305,133
Male,335,601,89,212,24٫92,256,173,307,134
Male,335,603,88,206,24٫64,257,169,281,112
Male,335,603,89,212,24٫92,251,176,304,128
Male,335,604,92,219,25٫76,250,180,332,152
Male,335,606,86,210,24٫08,250,176,310,134
Male,335,607,85,202,23٫8,254,182,309,127
Male,335,607,87,210,24٫36,252,166,280,114
Male,335,607,93,227,26٫04,245,184,334,150
Male,335,608,84,207,23٫52,252,178,311,133
Male,335,610,87,202,24٫36,252,170,294,124
Male,335,610,92,220,25٫76,263,182,305,123
Male,335,611,92,214,25٫76,266,177,297,120
Male,335,612,84,209,23٫52,253,174,299,125
Male,335,613,88,208,24٫64,265,179,324,145
Male,335,615,93,220,26٫04,262,181,326,145
Male,335,616,93,220,26٫04,265,178,330,152
Male,335,617,87,211,24٫36,260,181,325,144
Male,335,618,89,220,24٫92,262,182,311,129
Male,335,619,84,211,23٫52,267,182,326,144
Male,335,620,82,201,22٫96,259,164,297,133
Male,335,620,90,214,25٫2,260,176,322,146
Male,335,622,91,217,25٫48,255,182,335,153
Male,335,622,92,225,25٫76,262,183,326,143
Male,335,623,87,208,24٫36,258,168,298,130
Male,335,624,85,205,23٫8,267,165,301,136
Male,335,626,92,221,25٫76,268,169,306,137
Male,335,627,90,213,25٫2,264,171,302,131
Male,335,627,91,220,25٫48,261,174,307,133
Male,335,628,92,219,25٫76,266,178,317,139
Male,335,629,88,207,24٫64,260,172,283,111
Male,335,632,81,195,22٫68,264,168,280,112
Male,335,632,92,223,25٫76,259,178,320,142
Male,335,634,90,214,25٫2,269,163,303,140
Male,335,635,92,219,25٫76,262,168,318,150
Male,335,637,86,202,24٫08,259,166,275,109
Male,335,642,89,210,24٫92,262,164,298,134
Male,335,646,86,206,24٫08,271,165,286,121
Male,336,581,85,198,23٫8,249,167,296,129
Male,336,581,90,222,25٫2,252,175,315,140
Male,336,582,84,207,23٫52,248,169,292,123
Male,336,582,87,207,24٫36,248,170,311,141
Male,336,582,88,208,24٫64,255,175,286,111
Male,336,589,83,203,23٫24,256,174,309,135
Male,336,591,86,205,24٫08,254,174,290,116
Male,336,595,82,198,22٫96,252,169,303,134
Male,336,599,90,211,25٫2,258,175,293,118
Male,336,600,95,224,26٫6,265,179,328,149
Male,336,602,85,205,23٫8,265,172,317,145
Male,336,603,82,199,22٫96,257,163,287,124
Male,336,603,84,200,23٫52,250,176,320,144
Male,336,603,85,206,23٫8,251,173,302,129
Male,336,603,88,212,24٫64,251,179,292,113
Male,336,605,91,213,25٫48,250,183,297,114
Male,336,606,88,207,24٫64,251,170,311,141
Male,336,607,82,204,22٫96,257,169,297,128
Male,336,607,89,215,24٫92,262,182,323,141
Male,336,607,91,217,25٫48,262,162,288,126
Male,336,607,91,220,25٫48,247,174,296,122
Male,336,608,86,197,24٫08,263,176,287,111
Male,336,609,85,206,23٫8,259,170,300,130
Male,336,610,87,211,24٫36,256,175,314,139
Male,336,611,90,217,25٫2,254,175,327,152
Male,336,615,90,221,25٫2,247,172,298,126
Male,336,616,90,211,25٫2,269,170,288,118
Male,336,616,90,212,25٫2,258,174,304,130
Male,336,617,88,206,24٫64,261,170,288,118
Male,336,617,93,218,26٫04,264,177,316,139
Male,336,618,83,200,23٫24,259,172,287,115
Male,336,619,84,198,23٫52,264,175,317,142
Male,336,619,88,208,24٫64,258,171,281,110
Male,336,619,90,210,25٫2,261,176,309,133
Male,336,619,91,214,25٫48,264,187,324,137
Male,336,620,90,210,25٫2,257,179,296,117
Male,336,621,86,212,24٫08,262,167,290,123
Male,336,621,87,210,24٫36,269,170,311,141
Male,336,623,85,205,23٫8,261,166,284,118
Male,336,623,88,208,24٫64,265,176,311,135
Male,336,623,90,219,25٫2,267,184,306,122
Male,336,624,88,210,24٫64,264,174,307,133
Male,336,625,84,198,23٫52,262,165,284,119
Male,336,625,86,202,24٫08,265,175,309,134
Male,336,627,83,199,23٫24,268,167,309,142
Male,336,627,84,204,23٫52,267,166,288,122
Male,336,627,87,209,24٫36,258,177,293,116
Male,336,628,86,209,24٫08,262,171,300,129
Male,336,628,87,215,24٫36,266,186,298,112
Male,336,629,88,210,24٫64,263,166,298,132
Male,336,629,90,210,25٫2,267,175,307,132
Male,336,630,88,211,24٫64,260,170,325,155
Male,336,630,90,208,25٫2,268,168,310,142
Male,336,632,82,201,22٫96,271,165,295,130
Male,336,639,83,205,23٫24,261,168,322,154
Male,336,643,92,218,25٫76,263,168,304,136
Male,336,649,88,205,24٫64,260,163,280,117
Male,337,584,84,202,23٫52,252,170,320,150
Male,337,588,88,210,24٫64,254,170,312,142
Male,337,590,84,200,23٫52,259,171,315,144
Male,337,591,85,204,23٫8,251,173,308,135
Male,337,593,83,195,23٫24,257,172,329,157
Male,337,594,87,212,24٫36,249,178,332,154
Male,337,596,87,217,24٫36,250,172,318,146
Male,337,597,84,201,23٫52,254,170,296,126
Male,337,601,91,222,25٫48,252,176,331,155
Male,337,602,85,207,23٫8,260,169,283,114
Male,337,602,87,223,24٫36,257,182,324,142
Male,337,603,90,216,25٫2,253,185,321,136
Male,337,603,91,213,25٫48,260,173,321,148
Male,337,603,92,219,25٫76,250,178,319,141
Male,337,604,89,209,24٫92,261,174,299,125
Male,337,607,90,213,25٫2,253,181,332,151
Male,337,607,92,223,25٫76,260,180,321,141
Male,337,608,84,206,23٫52,263,170,311,141
Male,337,608,87,205,24٫36,261,179,308,129
Male,337,609,84,201,23٫52,262,162,284,122
Male,337,609,88,208,24٫64,263,166,292,126
Male,337,609,92,219,25٫76,261,173,302,129
Male,337,610,90,214,25٫2,260,170,310,140
Male,337,611,84,201,23٫52,260,165,290,125
Male,337,611,84,207,23٫52,265,170,292,122
Male,337,613,85,207,23٫8,252,177,294,117
Male,337,613,88,212,24٫64,260,177,303,126
Male,337,613,94,222,26٫32,260,189,344,155
Male,337,614,86,206,24٫08,257,173,330,157
Male,337,614,91,215,25٫48,253,186,312,126
Male,337,614,92,219,25٫76,252,175,309,134
Male,337,614,92,223,25٫76,253,190,327,137
Male,337,615,90,215,25٫2,259,168,317,149
Male,337,616,86,206,24٫08,261,168,292,124
Male,337,616,86,208,24٫08,264,179,317,138
Male,337,616,90,222,25٫2,261,174,291,117
Male,337,616,91,224,25٫48,259,177,308,131
Male,337,617,92,218,25٫76,252,179,298,119
Male,337,617,92,221,25٫76,260,178,327,149
Male,337,618,88,208,24٫64,260,180,335,155
Male,337,619,88,207,24٫64,263,164,285,121
Male,337,621,88,210,24٫64,258,172,299,127
Male,337,621,89,212,24٫92,264,175,337,162
Male,337,623,88,214,24٫64,265,180,298,118
Male,337,624,85,198,23٫8,261,164,275,111
Male,337,624,88,211,24٫64,268,165,294,129
Male,337,626,87,208,24٫36,264,180,330,150
Male,337,626,92,217,25٫76,270,173,298,125
Male,337,627,88,217,24٫64,260,180,310,130
Male,337,630,86,208,24٫08,258,179,306,127
Male,337,630,88,209,24٫64,262,165,279,114
Male,337,630,92,225,25٫76,259,190,340,150
Male,337,631,83,202,23٫24,277,165,285,120
Male,337,631,86,207,24٫08,262,175,311,136
Male,337,632,88,207,24٫64,263,178,296,118
Male,337,633,83,199,23٫24,258,165,298,133
Male,337,633,84,197,23٫52,266,173,290,117
Male,337,638,82,201,22٫96,274,162,292,130
Male,337,640,87,207,24٫36,269,174,290,116
Male,337,641,86,210,24٫08,268,175,325,150
Male,337,642,84,199,23٫52,266,168,294,126
Male,337,646,86,205,24٫08,265,169,312,143
Male,338,586,86,208,24٫08,249,183,330,147
Male,338,591,88,218,24٫64,249,186,343,157
Male,338,592,84,208,23٫52,252,164,301,137
Male,338,593,88,202,24٫64,256,168,285,117
Male,338,595,89,213,24٫92,255,174,294,120
Male,338,595,90,217,25٫2,259,181,313,132
Male,338,597,84,207,23٫52,250,172,327,155
Male,338,597,85,204,23٫8,252,171,302,131
Male,338,597,85,207,23٫8,250,172,296,124
Male,338,598,90,216,25٫2,260,183,336,153
Male,338,600,84,212,23٫52,249,177,314,137
Male,338,600,90,215,25٫2,260,173,330,157
Male,338,601,84,215,23٫52,252,188,330,142
Male,338,601,93,217,26٫04,247,180,325,145
Male,338,602,83,201,23٫24,246,164,312,148
Male,338,602,86,206,24٫08,257,174,303,129
Male,338,605,82,197,22٫96,246,166,293,127
Male,338,605,89,210,24٫92,256,175,332,157
Male,338,606,86,208,24٫08,266,173,294,121
Male,338,606,87,212,24٫36,261,165,298,133
Male,338,609,87,211,24٫36,263,176,306,130
Male,338,609,87,214,24٫36,257,183,328,145
Male,338,609,88,215,24٫64,263,166,306,140
Male,338,610,85,206,23٫8,258,166,290,124
Male,338,610,85,213,23٫8,253,170,299,129
Male,338,610,86,208,24٫08,255,170,305,135
Male,338,610,87,207,24٫36,259,173,307,134
Male,338,611,85,207,23٫8,255,171,295,124
Male,338,611,90,212,25٫2,260,176,299,123
Male,338,612,83,200,23٫24,255,173,293,120
Male,338,612,83,209,23٫24,263,170,306,136
Male,338,612,84,201,23٫52,254,176,303,127
Male,338,613,85,203,23٫8,253,171,308,137
Male,338,613,92,222,25٫76,248,175,300,125
Male,338,614,87,212,24٫36,263,178,318,140
Male,338,614,92,217,25٫76,261,185,309,124
Male,338,616,85,205,23٫8,265,163,297,134
Male,338,617,86,201,24٫08,272,165,285,120
Male,338,618,87,207,24٫36,255,177,312,135
Male,338,618,93,224,26٫04,261,177,300,123
Male,338,620,85,207,23٫8,258,167,290,123
Male,338,621,85,208,23٫8,257,177,293,116
Male,338,621,90,218,25٫2,257,179,337,158
Male,338,621,94,222,26٫32,257,188,328,140
Male,338,622,93,222,26٫04,248,185,322,137
Male,338,623,86,207,24٫08,259,168,295,127
Male,338,623,91,216,25٫48,263,171,291,120
Male,338,623,93,222,26٫04,267,181,314,133
Male,338,624,84,200,23٫52,269,175,286,111
Male,338,624,84,202,23٫52,263,169,305,136
Male,338,624,88,210,24٫64,260,173,316,143
Male,338,625,86,206,24٫08,259,173,294,121
Male,338,627,84,200,23٫52,262,170,300,130
Male,338,627,86,209,24٫08,263,170,301,131
Male,338,627,91,210,25٫48,259,169,300,131
Male,338,628,84,200,23٫52,266,165,293,128
Male,338,629,90,210,25٫2,270,173,286,113
Male,338,630,88,215,24٫64,261,178,332,154
Male,338,632,90,210,25٫2,262,167,286,119
Male,338,632,92,215,25٫76,266,178,302,124
Male,338,633,89,215,24٫92,261,175,329,154
Male,338,633,94,223,26٫32,273,175,323,148
Male,338,634,85,217,23٫8,278,180,338,158
Male,338,635,83,196,23٫24,264,173,284,111
Male,338,636,88,213,24٫64,271,177,304,127
Male,338,636,90,212,25٫2,269,173,289,116
Male,338,641,84,212,23٫52,262,167,311,144
Male,338,641,85,203,23٫8,270,165,283,118
Male,339,582,86,208,24٫08,252,171,328,157
Male,339,587,89,213,24٫92,249,176,326,150
Male,339,589,93,224,26٫04,248,180,340,160
Male,339,601,92,222,25٫76,252,185,334,149
Male,339,602,88,207,24٫64,252,180,318,138
Male,339,605,90,213,25٫2,257,173,306,133
Male,339,606,85,204,23٫8,263,168,290,122
Male,339,608,88,207,24٫64,259,169,299,130
Male,339,608,88,207,24٫64,260,172,291,119
Male,339,610,86,206,24٫08,258,169,303,134
Male,339,611,86,208,24٫08,266,169,323,154
Male,339,611,94,226,26٫32,262,185,308,123
Male,339,612,89,213,24٫92,257,177,333,156
Male,339,613,83,198,23٫24,262,168,302,134
Male,339,613,87,201,24٫36,257,163,291,128
Male,339,614,90,216,25٫2,260,169,289,120
Male,339,615,84,201,23٫52,259,176,308,132
Male,339,615,89,211,24٫92,261,182,332,150
Male,339,615,92,218,25٫76,255,174,313,139
Male,339,615,92,225,25٫76,252,182,330,148
Male,339,616,87,213,24٫36,254,171,322,151
Male,339,617,91,220,25٫48,254,182,302,120
Male,339,617,96,229,26٫88,255,189,322,133
Male,339,619,81,196,22٫68,264,170,297,127
Male,339,620,83,197,23٫24,260,163,301,138
Male,339,620,83,203,23٫24,266,167,279,112
Male,339,620,90,215,25٫2,260,168,310,142
Male,339,620,92,218,25٫76,257,182,312,130
Male,339,622,86,212,24٫08,258,176,301,125
Male,339,623,87,207,24٫36,257,164,290,126
Male,339,623,87,212,24٫36,265,171,312,141
Male,339,623,90,211,25٫2,263,165,305,140
Male,339,624,87,212,24٫36,254,187,335,148
Male,339,626,84,207,23٫52,261,174,288,114
Male,339,627,94,222,26٫32,266,178,305,127
Male,339,628,86,207,24٫08,265,170,290,120
Male,339,628,87,210,24٫36,254,167,298,131
Male,339,628,91,218,25٫48,264,178,299,121
Male,339,630,88,213,24٫64,262,174,295,121
Male,339,631,84,206,23٫52,262,169,293,124
Male,339,632,84,204,23٫52,259,175,311,136
Male,339,632,88,210,24٫64,272,165,278,113
Male,339,632,88,214,24٫64,266,175,312,137
Male,339,632,89,207,24٫92,278,167,324,157
Male,339,635,90,213,25٫2,267,175,315,140
Male,339,637,87,212,24٫36,266,173,316,143
Male,339,638,83,203,23٫24,274,171,293,122
Male,339,643,88,205,24٫64,273,171,298,127
Male,339,644,87,208,24٫36,262,173,310,137
Male,339,648,91,216,25٫48,272,180,327,147
Male,339,648,92,224,25٫76,276,182,303,121
Male,339,652,88,207,24٫64,264,176,302,126
Male,340,585,88,207,24٫64,249,171,316,145
Male,340,590,83,207,23٫24,257,178,312,134
Male,340,599,90,213,25٫2,255,172,317,145
Male,340,600,82,205,22٫96,259,168,322,154
Male,340,601,82,202,22٫96,254,174,302,128
Male,340,601,85,210,23٫8,257,177,307,130
Male,340,601,85,211,23٫8,256,168,287,119
Male,340,602,91,213,25٫48,268,180,322,142
Male,340,604,88,212,24٫64,251,168,311,143
Male,340,605,91,214,25٫48,250,173,305,132
Male,340,606,88,207,24٫64,256,171,286,115
Male,340,607,87,208,24٫36,260,173,300,127
Male,340,608,88,214,24٫64,262,178,317,139
Male,340,609,87,212,24٫36,263,183,322,139
Male,340,609,92,229,25٫76,250,185,326,141
Male,340,612,83,203,23٫24,262,173,322,149
Male,340,612,87,212,24٫36,277,173,285,112
Male,340,612,89,215,24٫92,255,180,322,142
Male,340,613,84,205,23٫52,261,172,305,133
Male,340,613,86,205,24٫08,270,163,278,115
Male,340,613,88,213,24٫64,253,177,328,151
Male,340,613,89,217,24٫92,256,181,325,144
Male,340,613,94,225,26٫32,251,177,332,155
Male,340,614,86,205,24٫08,263,174,292,118
Male,340,615,85,205,23٫8,261,170,311,141
Male,340,615,91,223,25٫48,257,182,335,153
Male,340,616,89,213,24٫92,254,170,299,129
Male,340,616,94,225,26٫32,260,178,324,146
Male,340,619,81,201,22٫68,269,168,284,116
Male,340,619,85,199,23٫8,260,170,297,127
Male,340,619,92,216,25٫76,269,179,323,144
Male,340,620,88,213,24٫64,265,183,324,141
Male,340,620,88,217,24٫64,266,175,303,128
Male,340,620,92,218,25٫76,259,186,318,132
Male,340,623,83,201,23٫24,263,167,295,128
Male,340,623,84,197,23٫52,266,169,284,115
Male,340,624,90,216,25٫2,256,177,287,110
Male,340,625,85,201,23٫8,264,177,313,136
Male,340,625,85,212,23٫8,261,170,292,122
Male,340,625,86,204,24٫08,263,168,292,124
Male,340,626,87,201,24٫36,268,177,301,124
Male,340,626,91,216,25٫48,265,173,295,122
Male,340,626,91,217,25٫48,266,182,320,138
Male,340,630,87,206,24٫36,255,165,289,124
Male,340,630,90,211,25٫2,264,178,295,117
Male,340,631,87,214,24٫36,267,169,281,112
Male,340,631,90,216,25٫2,269,180,324,144
Male,340,631,92,220,25٫76,268,173,296,123
Male,340,633,87,206,24٫36,272,168,288,120
Male,340,634,83,203,23٫24,267,167,288,121
Male,340,634,88,207,24٫64,265,175,293,118
Male,340,635,92,221,25٫76,271,174,307,133
Male,340,636,86,209,24٫08,266,177,320,143
Male,340,636,95,223,26٫6,270,180,306,126
Male,340,639,84,195,23٫52,264,165,280,115
Male,340,639,86,205,24٫08,273,166,281,115
Male,340,639,86,206,24٫08,267,170,290,120
Male,340,643,85,205,23٫8,265,179,289,110
Male,340,643,91,215,25٫48,268,179,304,125
Male,340,644,94,225,26٫32,258,180,305,125
Male,340,647,95,224,26٫6,269,184,322,138
Male,340,653,88,206,24٫64,274,170,300,130
Male,341,582,85,215,23٫8,248,165,299,134
Male,341,585,85,199,23٫8,256,183,335,152
Male,341,590,87,210,24٫36,256,185,342,157
Male,341,590,90,218,25٫2,248,175,301,126
Male,341,592,87,212,24٫36,261,184,322,138
Male,341,592,93,227,26٫04,245,179,312,133
Male,341,595,85,208,23٫8,258,178,327,149
Male,341,598,83,212,23٫24,256,168,314,146
Male,341,601,89,215,24٫92,251,181,324,143
Male,341,603,89,215,24٫92,248,183,336,153
Male,341,603,90,211,25٫2,257,179,315,136
Male,341,604,84,205,23٫52,265,165,322,157
Male,341,605,84,202,23٫52,256,166,311,145
Male,341,605,89,213,24٫92,258,173,315,142
Male,341,605,91,217,25٫48,251,175,332,157
Male,341,607,89,212,24٫92,257,179,318,139
Male,341,610,82,204,22٫96,257,169,280,111
Male,341,610,83,199,23٫24,261,168,279,111
Male,341,610,90,214,25٫2,252,170,303,133
Male,341,610,90,218,25٫2,263,184,311,127
Male,341,610,91,214,25٫48,256,179,312,133
Male,341,612,81,195,22٫68,254,165,291,126
Male,341,612,87,208,24٫36,261,164,288,124
Male,341,612,88,214,24٫64,266,179,315,136
Male,341,613,84,203,23٫52,259,168,297,129
Male,341,613,88,207,24٫64,252,178,296,118
Male,341,613,90,216,25٫2,262,171,318,147
Male,341,614,89,220,24٫92,254,175,326,151
Male,341,615,88,209,24٫64,267,178,308,130
Male,341,615,90,215,25٫2,264,178,308,130
Male,341,615,93,223,26٫04,261,182,314,132
Male,341,617,88,206,24٫64,266,171,303,132
Male,341,617,89,224,24٫92,267,170,304,134
Male,341,617,91,221,25٫48,264,181,311,130
Male,341,619,88,209,24٫64,258,173,321,148
Male,341,619,89,212,24٫92,259,182,322,140
Male,341,620,88,212,24٫64,252,185,308,123
Male,341,620,91,222,25٫48,245,182,314,132
Male,341,620,92,218,25٫76,265,182,298,116
Male,341,621,87,213,24٫36,250,177,320,143
Male,341,621,89,217,24٫92,257,174,319,145
Male,341,621,94,222,26٫32,265,178,327,149
Male,341,622,88,207,24٫64,260,170,312,142
Male,341,623,86,213,24٫08,255,180,303,123
Male,341,623,88,216,24٫64,257,178,327,149
Male,341,623,89,206,24٫92,261,165,299,134
Male,341,624,84,207,23٫52,261,176,302,126
Male,341,624,88,212,24٫64,260,171,294,123
Male,341,625,87,212,24٫36,268,173,301,128
Male,341,627,87,209,24٫36,261,169,296,127
Male,341,627,88,208,24٫64,266,169,302,133
Male,341,627,88,208,24٫64,271,165,303,138
Male,341,627,94,214,26٫32,262,180,315,135
Male,341,628,90,212,25٫2,275,171,319,148
Male,341,628,91,218,25٫48,265,176,330,154
Male,341,629,85,198,23٫8,267,170,295,125
Male,341,629,88,216,24٫64,264,180,304,124
Male,341,629,88,217,24٫64,272,175,310,135
Male,341,630,82,201,22٫96,264,180,308,128
Male,341,630,82,202,22٫96,265,167,287,120
Male,341,630,90,220,25٫2,271,177,307,130
Male,341,631,84,205,23٫52,267,171,324,153
Male,341,632,91,219,25٫48,271,166,310,144
Male,341,633,88,213,24٫64,268,182,326,144
Male,341,633,90,212,25٫2,262,181,297,116
Male,341,635,88,215,24٫64,258,174,288,114
Male,341,635,91,215,25٫48,266,179,316,137
Male,341,636,85,203,23٫8,268,174,313,139
Male,341,637,87,208,24٫36,264,171,280,109
Male,341,637,93,220,26٫04,270,177,304,127
Male,341,639,93,225,26٫04,261,181,334,153
Male,341,640,85,201,23٫8,270,165,289,124
Male,341,644,87,205,24٫36,270,176,302,126
Male,341,645,84,197,23٫52,271,163,292,129
Male,341,645,87,214,24٫36,259,169,301,132
Male,341,645,88,212,24٫64,274,176,309,133
Male,341,648,83,201,23٫24,279,164,294,130
Male,341,650,89,206,24٫92,270,178,298,120
Male,341,654,90,218,25٫2,274,175,302,127
Male,342,587,87,210,24٫36,244,172,308,136
Male,342,595,81,195,22٫68,252,167,285,118
Male,342,600,86,213,24٫08,255,173,295,122
Male,342,604,84,213,23٫52,256,175,300,125
Male,342,604,89,214,24٫92,262,177,314,137
Male,342,605,91,217,25٫48,259,173,290,117
Male,342,607,86,206,24٫08,258,174,300,126
Male,342,608,88,208,24٫64,259,170,298,128
Male,342,608,88,213,24٫64,261,177,294,117
Male,342,610,86,204,24٫08,254,174,308,134
Male,342,611,84,203,23٫52,267,174,318,144
Male,342,611,87,210,24٫36,269,178,293,115
Male,342,613,86,207,24٫08,259,174,291,117
Male,342,613,88,217,24٫64,258,175,307,132
Male,342,614,82,200,22٫96,259,170,302,132
Male,342,614,87,208,24٫36,262,172,288,116
Male,342,615,82,198,22٫96,261,165,288,123
Male,342,615,83,196,23٫24,258,177,311,134
Male,342,615,88,205,24٫64,262,173,300,127
Male,342,615,90,221,25٫2,261,177,329,152
Male,342,616,84,207,23٫52,268,172,291,119
Male,342,616,86,214,24٫08,258,178,330,152
Male,342,616,89,220,24٫92,258,179,308,129
Male,342,619,84,208,23٫52,262,171,297,126
Male,342,619,87,207,24٫36,265,172,297,125
Male,342,620,82,197,22٫96,265,167,286,119
Male,342,620,88,203,24٫64,260,165,294,129
Male,342,621,82,200,22٫96,263,167,296,129
Male,342,621,83,204,23٫24,263,175,307,132
Male,342,622,86,207,24٫08,269,168,295,127
Male,342,622,90,227,25٫2,259,183,322,139
Male,342,623,89,213,24٫92,260,171,288,117
Male,342,624,89,214,24٫92,263,165,315,150
Male,342,626,84,207,23٫52,279,174,319,145
Male,342,626,87,211,24٫36,265,177,305,128
Male,342,626,89,207,24٫92,258,175,302,127
Male,342,627,88,213,24٫64,260,183,308,125
Male,342,628,82,197,22٫96,270,172,334,162
Male,342,628,88,205,24٫64,273,176,287,111
Male,342,628,88,208,24٫64,274,171,303,132
Male,342,628,88,216,24٫64,267,175,294,119
Male,342,629,84,211,23٫52,266,175,311,136
Male,342,631,86,204,24٫08,272,176,300,124
Male,342,632,90,216,25٫2,258,175,322,147
Male,342,633,90,220,25٫2,271,178,289,111
Male,342,633,91,220,25٫48,252,169,310,141
Male,342,634,87,209,24٫36,269,168,298,130
Male,342,635,90,217,25٫2,271,176,291,115
Male,342,636,88,207,24٫64,266,167,279,112
Male,342,636,92,228,25٫76,265,186,329,143
Male,342,639,87,210,24٫36,268,174,324,150
Male,342,640,92,217,25٫76,268,177,292,115
Male,342,641,90,213,25٫2,277,178,320,142
Male,342,649,85,200,23٫8,270,165,277,112
Male,342,654,85,202,23٫8,283,164,286,122
Male,342,660,89,206,24٫92,267,175,294,119
Male,343,584,85,208,23٫8,252,170,325,155
Male,343,589,83,198,23٫24,255,164,298,134
Male,343,591,90,212,25٫2,260,184,335,151
Male,343,596,87,203,24٫36,258,166,279,113
Male,343,598,84,199,23٫52,259,169,277,108
Male,343,600,87,215,24٫36,252,178,324,146
Male,343,603,88,208,24٫64,253,172,287,115
Male,343,604,88,217,24٫64,254,187,339,152
Male,343,605,92,218,25٫76,263,180,306,126
Male,343,606,95,223,26٫6,260,179,314,135
Male,343,607,85,204,23٫8,262,179,300,121
Male,343,607,86,202,24٫08,256,168,317,149
Male,343,607,89,217,24٫92,266,181,306,125
Male,343,608,88,213,24٫64,253,173,283,110
Male,343,609,85,209,23٫8,260,173,315,142
Male,343,609,92,223,25٫76,248,176,322,146
Male,343,613,87,209,24٫36,258,176,310,134
Male,343,613,90,202,25٫2,262,172,300,128
Male,343,613,90,220,25٫2,246,190,339,149
Male,343,614,85,213,23٫8,254,163,292,129
Male,343,614,86,212,24٫08,254,172,295,123
Male,343,614,89,219,24٫92,265,182,314,132
Male,343,615,92,220,25٫76,247,182,334,152
Male,343,616,82,202,22٫96,260,173,333,160
Male,343,616,84,206,23٫52,252,178,331,153
Male,343,616,88,214,24٫64,264,180,340,160
Male,343,616,89,215,24٫92,251,181,316,135
Male,343,616,90,218,25٫2,252,187,339,152
Male,343,618,85,201,23٫8,259,173,294,121
Male,343,618,85,209,23٫8,258,168,292,124
Male,343,618,88,215,24٫64,267,180,316,136
Male,343,619,85,200,23٫8,263,173,300,127
Male,343,619,86,208,24٫08,266,180,300,120
Male,343,619,87,210,24٫36,261,172,294,122
Male,343,619,95,225,26٫6,259,182,321,139
Male,343,620,84,202,23٫52,261,164,285,121
Male,343,620,87,213,24٫36,257,178,311,133
Male,343,621,84,204,23٫52,259,176,308,132
Male,343,621,84,208,23٫52,261,174,322,148
Male,343,621,88,206,24٫64,261,178,300,122
Male,343,622,84,201,23٫52,267,168,281,113
Male,343,622,85,199,23٫8,268,172,329,157
Male,343,622,85,206,23٫8,259,171,319,148
Male,343,622,91,215,25٫48,271,168,306,138
Male,343,624,88,214,24٫64,265,177,316,139
Male,343,625,84,200,23٫52,266,170,294,124
Male,343,625,86,208,24٫08,268,171,317,146
Male,343,625,86,210,24٫08,268,172,306,134
Male,343,625,90,216,25٫2,259,173,288,115
Male,343,625,91,212,25٫48,262,168,301,133
Male,343,626,86,210,24٫08,265,168,304,136
Male,343,626,89,204,24٫92,263,176,317,141
Male,343,626,90,217,25٫2,261,179,296,117
Male,343,626,90,224,25٫2,258,188,332,144
Male,343,627,91,217,25٫48,272,178,304,126
Male,343,629,83,198,23٫24,254,162,279,117
Male,343,629,88,220,24٫64,257,188,325,137
Male,343,630,87,211,24٫36,263,180,322,142
Male,343,630,88,211,24٫64,266,180,324,144
Male,343,632,89,220,24٫92,258,182,319,137
Male,343,632,91,218,25٫48,266,182,330,148
Male,343,634,85,202,23٫8,271,170,295,125
Male,343,634,88,213,24٫64,260,168,288,120
Male,343,634,92,218,25٫76,268,178,328,150
Male,343,634,94,217,26٫32,270,174,302,128
Male,343,636,89,217,24٫92,258,186,325,139
Male,343,636,94,225,26٫32,265,179,326,147
Male,343,637,88,214,24٫64,268,178,298,120
Male,343,638,88,205,24٫64,263,178,328,150
Male,343,641,86,211,24٫08,261,171,288,117
Male,343,644,91,215,25٫48,271,183,325,142
Male,343,647,86,209,24٫08,269,173,297,124
Male,343,653,91,213,25٫48,272,190,337,147
Male,343,654,88,215,24٫64,267,180,334,154
Male,343,662,86,210,24٫08,277,180,318,138
Male,344,599,90,215,25٫2,256,178,301,123
Male,344,601,88,213,24٫64,262,177,319,142
Male,344,602,90,216,25٫2,250,180,330,150
Male,344,603,85,209,23٫8,254,169,278,109
Male,344,604,85,211,23٫8,248,172,312,140
Male,344,604,89,213,24٫92,257,179,332,153
Male,344,608,87,211,24٫36,257,175,316,141
Male,344,608,90,214,25٫2,263,171,314,143
Male,344,609,84,207,23٫52,257,175,309,134
Male,344,609,90,223,25٫2,262,186,333,147
Male,344,610,84,208,23٫52,271,167,288,121
Male,344,611,88,214,24٫64,257,180,323,143
Male,344,612,87,214,24٫36,266,176,289,113
Male,344,614,88,208,24٫64,267,176,293,117
Male,344,615,82,202,22٫96,273,167,311,144
Male,344,615,83,200,23٫24,260,170,313,143
Male,344,615,92,224,25٫76,263,169,318,149
Male,344,616,90,210,25٫2,266,171,297,126
Male,344,617,83,200,23٫24,256,167,287,120
Male,344,617,84,200,23٫52,265,163,284,121
Male,344,617,86,203,24٫08,263,177,333,156
Male,344,617,87,207,24٫36,259,175,305,130
Male,344,617,89,213,24٫92,255,173,309,136
Male,344,617,94,217,26٫32,260,179,306,127
Male,344,618,84,208,23٫52,263,171,297,126
Male,344,618,88,214,24٫64,273,181,327,146
Male,344,618,92,227,25٫76,267,184,338,154
Male,344,618,94,221,26٫32,262,183,312,129
Male,344,619,89,212,24٫92,255,172,301,129
Male,344,621,91,215,25٫48,264,174,315,141
Male,344,621,91,218,25٫48,257,184,323,139
Male,344,622,87,204,24٫36,269,182,321,139
Male,344,622,92,217,25٫76,263,182,308,126
Male,344,623,88,207,24٫64,268,175,302,127
Male,344,623,88,217,24٫64,266,182,304,122
Male,344,623,90,219,25٫2,262,184,333,149
Male,344,624,83,197,23٫24,266,164,281,117
Male,344,624,86,214,24٫08,260,181,300,119
Male,344,624,87,207,24٫36,261,177,295,118
Male,344,626,86,206,24٫08,261,174,292,118
Male,344,626,89,206,24٫92,267,172,320,148
Male,344,626,93,224,26٫04,263,187,331,144
Male,344,627,85,207,23٫8,260,180,316,136
Male,344,627,92,217,25٫76,268,175,308,133
Male,344,628,84,202,23٫52,272,165,296,131
Male,344,628,88,207,24٫64,269,172,289,117
Male,344,628,88,214,24٫64,262,178,314,136
Male,344,628,92,218,25٫76,264,180,325,145
Male,344,628,93,223,26٫04,256,189,328,139
Male,344,629,85,204,23٫8,269,182,316,134
Male,344,629,86,206,24٫08,267,177,299,122
Male,344,629,87,212,24٫36,272,179,322,143
Male,344,629,88,214,24٫64,261,181,327,146
Male,344,629,94,218,26٫32,267,170,292,122
Male,344,631,81,199,22٫68,264,163,324,161
Male,344,631,90,205,25٫2,273,177,312,135
Male,344,632,85,204,23٫8,270,170,290,120
Male,344,632,88,212,24٫64,266,174,320,146
Male,344,632,88,217,24٫64,262,180,328,148
Male,344,632,89,213,24٫92,269,181,293,112
Male,344,633,86,201,24٫08,266,164,289,125
Male,344,633,87,206,24٫36,259,182,303,121
Male,344,634,89,214,24٫92,262,172,320,148
Male,344,635,89,213,24٫92,264,173,304,131
Male,344,637,88,218,24٫64,275,167,306,139
Male,344,637,89,211,24٫92,255,179,316,137
Male,344,637,91,218,25٫48,261,181,319,138
Male,344,638,88,216,24٫64,272,177,318,141
Male,344,639,85,206,23٫8,270,175,327,152
Male,344,639,88,214,24٫64,272,170,301,131
Male,344,640,87,215,24٫36,263,170,285,115
Male,344,642,87,213,24٫36,271,186,333,147
Male,344,642,93,220,26٫04,275,189,331,142
Male,344,643,91,215,25٫48,272,169,314,145
Male,344,645,88,209,24٫64,279,175,331,156
Male,344,646,85,213,23٫8,278,178,310,132
Male,344,646,93,222,26٫04,268,180,302,122
Male,344,648,87,212,24٫36,275,175,309,134
Male,344,649,87,210,24٫36,271,178,310,132
Male,344,651,84,204,23٫52,271,176,296,120
Male,344,656,83,202,23٫24,279,175,296,121
Male,344,657,88,215,24٫64,268,169,302,133
Male,344,658,83,200,23٫24,278,175,312,137
Male,345,593,86,205,24٫08,267,174,332,158
Male,345,594,91,215,25٫48,255,170,295,125
Male,345,598,88,207,24٫64,257,165,299,134
Male,345,601,91,217,25٫48,256,172,321,149
Male,345,601,92,220,25٫76,256,170,324,154
Male,345,602,86,211,24٫08,256,164,287,123
Male,345,604,82,196,22٫96,268,167,289,122
Male,345,604,92,222,25٫76,255,182,331,149
Male,345,605,84,202,23٫52,258,170,295,125
Male,345,605,85,200,23٫8,257,175,290,115
Male,345,606,84,195,23٫52,255,169,291,122
Male,345,606,86,212,24٫08,259,179,324,145
Male,345,606,92,220,25٫76,262,187,322,135
Male,345,607,82,198,22٫96,263,168,280,112
Male,345,607,87,212,24٫36,259,177,312,135
Male,345,609,89,224,24٫92,257,177,315,138
Male,345,610,88,212,24٫64,265,167,304,137
Male,345,611,89,212,24٫92,266,174,306,132
Male,345,612,88,215,24٫64,253,175,308,133
Male,345,612,89,215,24٫92,262,173,292,119
Male,345,615,85,203,23٫8,263,169,311,142
Male,345,615,89,214,24٫92,265,183,313,130
Male,345,615,94,223,26٫32,254,177,314,137
Male,345,617,87,214,24٫36,260,181,304,123
Male,345,619,81,197,22٫68,259,165,276,111
Male,345,619,89,217,24٫92,262,184,320,136
Male,345,619,92,222,25٫76,255,188,319,131
Male,345,620,84,205,23٫52,268,171,312,141
Male,345,620,84,208,23٫52,262,175,290,115
Male,345,620,86,204,24٫08,261,173,296,123
Male,345,620,93,221,26٫04,260,182,335,153
Male,345,622,92,212,25٫76,265,178,322,144
Male,345,625,88,215,24٫64,266,167,286,119
Male,345,625,94,223,26٫32,276,188,328,140
Male,345,626,83,206,23٫24,254,175,298,123
Male,345,626,88,213,24٫64,256,179,317,138
Male,345,627,82,197,22٫96,270,167,279,112
Male,345,627,88,213,24٫64,263,175,297,122
Male,345,627,90,217,25٫2,260,170,300,130
Male,345,628,87,208,24٫36,273,169,299,130
Male,345,629,82,197,22٫96,274,165,290,125
Male,345,629,88,214,24٫64,254,172,294,122
Male,345,629,88,214,24٫64,263,177,300,123
Male,345,630,87,205,24٫36,263,178,303,125
Male,345,630,87,213,24٫36,267,168,312,144
Male,345,632,84,205,23٫52,269,180,298,118
Male,345,633,83,197,23٫24,275,163,298,135
Male,345,633,87,207,24٫36,263,178,302,124
Male,345,633,90,214,25٫2,261,176,288,112
Male,345,634,86,205,24٫08,262,172,302,130
Male,345,634,96,230,26٫88,271,182,343,161
Male,345,635,87,212,24٫36,269,183,318,135
Male,345,635,91,212,25٫48,274,186,301,115
Male,345,636,86,207,24٫08,275,172,297,125
Male,345,637,82,200,22٫96,269,179,290,111
Male,345,637,83,198,23٫24,271,170,306,136
Male,345,638,90,213,25٫2,274,177,312,135
Male,345,638,93,225,26٫04,271,176,321,145
Male,345,639,88,208,24٫64,267,168,298,130
Male,345,639,88,210,24٫64,259,171,291,120
Male,345,640,88,204,24٫64,266,166,275,109
Male,345,642,88,209,24٫64,275,168,309,141
Male,345,643,81,201,22٫68,281,168,327,159
Male,345,645,91,218,25٫48,267,176,310,134
Male,345,646,88,210,24٫64,269,186,325,139
Male,345,646,91,216,25٫48,260,182,316,134
Male,345,647,88,210,24٫64,272,168,303,135
Male,345,648,84,204,23٫52,266,174,312,138
Male,345,649,82,198,22٫96,271,162,276,114
Male,345,649,85,208,23٫8,269,176,284,108
Male,345,652,84,202,23٫52,287,165,289,124
Male,345,652,90,210,25٫2,271,178,326,148
Male,345,654,89,216,24٫92,275,181,334,153
Male,345,656,85,199,23٫8,274,170,281,111
Male,345,656,90,217,25٫2,276,177,302,125
Male,345,661,90,213,25٫2,277,179,310,131
Male,345,664,84,207,23٫52,277,174,315,141
Male,346,596,86,204,24٫08,256,166,288,122
Male,346,600,87,213,24٫36,255,176,326,150
Male,346,605,90,221,25٫2,249,183,321,138
Male,346,608,87,214,24٫36,257,167,319,152
Male,346,609,83,205,23٫24,264,185,322,137
Male,346,609,86,207,24٫08,262,167,298,131
Male,346,610,82,197,22٫96,254,168,299,131
Male,346,611,86,207,24٫08,268,169,299,130
Male,346,611,90,215,25٫2,266,167,306,139
Male,346,612,89,214,24٫92,256,178,306,128
Male,346,612,92,224,25٫76,262,180,309,129
Male,346,615,87,211,24٫36,258,174,312,138
Male,346,616,84,206,23٫52,256,187,327,140
Male,346,616,86,200,24٫08,267,165,297,132
Male,346,616,88,206,24٫64,253,170,300,130
Male,346,617,87,205,24٫36,260,174,300,126
Male,346,618,85,205,23٫8,269,174,297,123
Male,346,619,84,201,23٫52,261,172,297,125
Male,346,620,86,207,24٫08,260,170,308,138
Male,346,620,87,212,24٫36,263,178,315,137
Male,346,621,93,226,26٫04,263,180,316,136
Male,346,622,90,212,25٫2,270,182,322,140
Male,346,623,91,217,25٫48,262,176,298,122
Male,346,623,92,218,25٫76,259,174,317,143
Male,346,623,94,223,26٫32,263,186,335,149
Male,346,624,87,213,24٫36,272,178,305,127
Male,346,624,93,218,26٫04,265,184,318,134
Male,346,625,88,214,24٫64,260,172,312,140
Male,346,625,89,216,24٫92,261,181,333,152
Male,346,625,91,214,25٫48,269,175,321,146
Male,346,626,85,203,23٫8,263,171,298,127
Male,346,626,87,210,24٫36,258,172,301,129
Male,346,628,84,206,23٫52,261,183,335,152
Male,346,628,86,204,24٫08,266,186,296,110
Male,346,628,90,215,25٫2,265,180,308,128
Male,346,628,90,217,25٫2,267,181,322,141
Male,346,628,93,221,26٫04,265,180,303,123
Male,346,629,83,198,23٫24,264,166,280,114
Male,346,630,88,209,24٫64,271,180,296,116
Male,346,631,87,218,24٫36,263,191,317,126
Male,346,631,88,213,24٫64,277,178,311,133
Male,346,631,93,218,26٫04,261,177,302,125
Male,346,631,93,223,26٫04,270,179,323,144
Male,346,633,81,197,22٫68,268,165,289,124
Male,346,633,85,203,23٫8,275,171,308,137
Male,346,633,94,218,26٫32,267,176,296,120
Male,346,634,83,199,23٫24,267,169,279,110
Male,346,634,89,218,24٫92,260,181,331,150
Male,346,635,86,202,24٫08,270,168,290,122
Male,346,635,92,218,25٫76,274,178,330,152
Male,346,637,87,212,24٫36,264,190,327,137
Male,346,637,87,212,24٫36,273,167,293,126
Male,346,638,83,205,23٫24,274,168,298,130
Male,346,639,86,213,24٫08,270,176,310,134
Male,346,640,83,203,23٫24,270,167,300,133
Male,346,640,89,213,24٫92,268,178,307,129
Male,346,642,86,208,24٫08,271,175,297,122
Male,346,642,88,207,24٫64,260,182,320,138
Male,346,642,88,207,24٫64,280,167,303,136
Male,346,643,90,214,25٫2,265,171,291,120
Male,346,644,85,200,23٫8,274,162,283,121
Male,346,644,85,207,23٫8,277,173,296,123
Male,346,645,90,218,25٫2,275,180,302,122
Male,346,647,88,210,24٫64,266,180,316,136
Male,346,649,88,213,24٫64,264,168,286,118
Male,346,651,84,207,23٫52,277,170,318,148
Male,346,652,87,208,24٫36,272,183,314,131
Male,346,658,88,208,24٫64,271,171,308,137
Male,346,666,85,208,23٫8,288,180,313,133
Male,346,672,95,228,26٫6,278,185,327,142
Male,346,673,92,210,25٫76,281,185,309,124
Male,347,597,89,214,24٫92,252,177,315,138
Male,347,601,83,201,23٫24,270,164,288,124
Male,347,603,86,215,24٫08,251,185,317,132
Male,347,603,93,226,26٫04,269,176,335,159
Male,347,605,88,208,24٫64,253,180,307,127
Male,347,608,88,215,24٫64,260,183,322,139
Male,347,610,89,209,24٫92,253,173,333,160
Male,347,611,90,214,25٫2,249,173,294,121
Male,347,613,86,206,24٫08,263,163,285,122
Male,347,613,92,220,25٫76,264,188,333,145
Male,347,614,87,207,24٫36,265,182,302,120
Male,347,614,89,215,24٫92,254,181,342,161
Male,347,615,84,203,23٫52,265,170,310,140
Male,347,617,94,225,26٫32,260,187,334,147
Male,347,618,84,207,23٫52,267,171,285,114
Male,347,618,87,208,24٫36,266,167,312,145
Male,347,619,88,208,24٫64,255,172,300,128
Male,347,619,89,218,24٫92,268,185,333,148
Male,347,622,87,212,24٫36,270,173,311,138
Male,347,623,82,200,22٫96,264,171,320,149
Male,347,623,86,203,24٫08,259,171,286,115
Male,347,623,87,207,24٫36,271,165,295,130
Male,347,623,87,208,24٫36,259,169,291,122
Male,347,623,87,213,24٫36,272,175,307,132
Male,347,623,95,227,26٫6,261,176,307,131
Male,347,624,82,198,22٫96,274,177,320,143
Male,347,625,82,205,22٫96,272,174,306,132
Male,347,627,87,208,24٫36,261,178,331,153
Male,347,627,88,208,24٫64,261,176,321,145
Male,347,627,88,214,24٫64,257,178,317,139
Male,347,628,84,204,23٫52,259,174,286,112
Male,347,628,86,206,24٫08,265,178,327,149
Male,347,628,88,212,24٫64,271,176,306,130
Male,347,628,90,216,25٫2,267,184,333,149
Male,347,630,91,217,25٫48,269,175,313,138
Male,347,630,91,220,25٫48,261,177,314,137
Male,347,632,88,209,24٫64,272,169,281,112
Male,347,633,84,208,23٫52,265,168,310,142
Male,347,633,88,203,24٫64,270,171,281,110
Male,347,635,86,209,24٫08,266,173,321,148
Male,347,635,90,213,25٫2,276,182,334,152
Male,347,635,92,223,25٫76,277,184,335,151
Male,347,636,87,214,24٫36,277,168,290,122
Male,347,636,88,214,24٫64,263,175,321,146
Male,347,636,92,217,25٫76,271,179,324,145
Male,347,639,88,214,24٫64,267,179,320,141
Male,347,639,91,221,25٫48,266,177,308,131
Male,347,640,84,206,23٫52,279,169,319,150
Male,347,640,85,215,23٫8,268,172,312,140
Male,347,640,88,217,24٫64,274,180,333,153
Male,347,641,94,222,26٫32,274,180,328,148
Male,347,642,87,208,24٫36,277,173,311,138
Male,347,642,89,210,24٫92,280,174,308,134
Male,347,643,95,226,26٫6,263,180,325,145
Male,347,644,83,204,23٫24,265,179,320,141
Male,347,644,85,203,23٫8,282,167,293,126
Male,347,646,88,212,24٫64,272,183,334,151
Male,347,647,90,220,25٫2,276,174,299,125
Male,347,647,91,221,25٫48,267,178,297,119
Male,347,647,92,220,25٫76,274,190,310,120
Male,347,647,94,225,26٫32,273,181,293,112
Male,347,648,85,199,23٫8,279,172,292,120
Male,347,648,85,203,23٫8,271,164,300,136
Male,347,648,86,206,24٫08,278,173,291,118
Male,347,652,84,203,23٫52,278,177,312,135
Male,347,653,86,208,24٫08,279,180,292,112
Male,347,655,87,212,24٫36,284,180,299,119
Male,347,656,90,211,25٫2,274,181,322,141
Male,347,661,87,206,24٫36,278,165,275,110
Male,347,665,89,222,24٫92,270,187,326,139
Male,347,674,90,215,25٫2,287,175,322,147
Male,348,590,85,216,23٫8,253,183,336,153
Male,348,594,83,202,23٫24,263,181,325,144
Male,348,595,88,217,24٫64,255,180,313,133
Male,348,596,91,212,25٫48,269,181,331,150
Male,348,597,88,210,24٫64,251,171,293,122
Male,348,601,87,212,24٫36,252,177,292,115
Male,348,606,93,221,26٫04,249,177,313,136
Male,348,606,95,227,26٫6,262,181,333,152
Male,348,607,86,203,24٫08,254,167,289,122
Male,348,607,86,204,24٫08,262,176,288,112
Male,348,607,90,221,25٫2,253,183,330,147
Male,348,608,85,205,23٫8,261,180,303,123
Male,348,610,90,215,25٫2,264,168,307,139
Male,348,610,91,215,25٫48,252,165,305,140
Male,348,610,94,225,26٫32,252,182,321,139
Male,348,611,90,215,25٫2,257,167,311,144
Male,348,612,90,221,25٫2,264,180,325,145
Male,348,613,88,206,24٫64,254,165,317,152
Male,348,613,88,224,24٫64,249,180,310,130
Male,348,613,90,223,25٫2,255,178,323,145
Male,348,614,83,200,23٫24,258,170,300,130
Male,348,614,88,214,24٫64,250,176,313,137
Male,348,614,95,225,26٫6,265,175,293,118
Male,348,615,86,217,24٫08,262,173,308,135
Male,348,615,88,218,24٫64,254,178,338,160
Male,348,615,89,208,24٫92,262,174,286,112
Male,348,615,92,218,25٫76,270,178,312,134
Male,348,616,89,213,24٫92,263,176,325,149
Male,348,618,88,213,24٫64,260,183,326,143
Male,348,619,89,217,24٫92,255,178,310,132
Male,348,619,91,214,25٫48,254,177,309,132
Male,348,621,89,214,24٫92,262,184,322,138
Male,348,622,85,203,23٫8,262,166,277,111
Male,348,622,89,210,24٫92,260,173,300,127
Male,348,623,82,202,22٫96,265,177,322,145
Male,348,623,88,217,24٫64,262,182,314,132
Male,348,623,91,215,25٫48,270,174,301,127
Male,348,624,85,207,23٫8,262,183,318,135
Male,348,624,87,208,24٫36,257,170,312,142
Male,348,625,88,213,24٫64,263,168,308,140
Male,348,626,89,213,24٫92,267,173,308,135
Male,348,626,92,226,25٫76,271,185,315,130
Male,348,627,86,207,24٫08,267,173,288,115
Male,348,627,92,227,25٫76,262,186,331,145
Male,348,628,87,209,24٫36,263,175,314,139
Male,348,628,88,207,24٫64,268,167,302,135
Male,348,629,84,206,23٫52,254,167,289,122
Male,348,629,85,212,23٫8,266,172,300,128
Male,348,630,84,199,23٫52,273,168,301,133
Male,348,630,91,218,25٫48,264,185,339,154
Male,348,630,92,220,25٫76,270,187,332,145
Male,348,631,85,203,23٫8,266,170,326,156
Male,348,631,85,210,23٫8,271,182,337,155
Male,348,631,88,205,24٫64,257,176,313,137
Male,348,632,87,203,24٫36,277,168,307,139
Male,348,632,91,219,25٫48,266,181,343,162
Male,348,633,82,204,22٫96,261,165,290,125
Male,348,633,89,216,24٫92,272,168,282,114
Male,348,634,88,213,24٫64,271,179,317,138
Male,348,634,93,223,26٫04,268,187,345,158
Male,348,635,94,220,26٫32,262,177,314,137
Male,348,636,87,216,24٫36,265,177,302,125
Male,348,637,89,221,24٫92,273,175,311,136
Male,348,638,86,209,24٫08,266,176,303,127
Male,348,639,87,207,24٫36,270,177,312,135
Male,348,640,85,205,23٫8,265,169,290,121
Male,348,640,88,213,24٫64,273,182,325,143
Male,348,640,90,210,25٫2,267,181,313,132
Male,348,641,87,208,24٫36,271,173,327,154
Male,348,641,87,210,24٫36,272,166,298,132
Male,348,641,90,214,25٫2,273,174,308,134
Male,348,641,90,220,25٫2,275,188,339,151
Male,348,642,89,215,24٫92,277,180,325,145
Male,348,645,85,203,23٫8,272,173,283,110
Male,348,645,87,207,24٫36,274,169,279,110
Male,348,645,87,207,24٫36,274,183,331,148
Male,348,645,92,218,25٫76,267,187,300,113
Male,348,647,89,212,24٫92,273,170,294,124
Male,348,647,91,216,25٫48,273,181,300,119
Male,348,648,86,200,24٫08,274,170,295,125
Male,348,649,84,203,23٫52,276,175,286,111
Male,348,650,85,213,23٫8,272,177,295,118
Male,348,650,90,220,25٫2,277,184,306,122
Male,348,651,83,195,23٫24,273,171,289,118
Male,348,651,93,219,26٫04,277,169,325,156
Male,348,653,88,208,24٫64,266,175,312,137
Male,348,654,83,200,23٫24,271,171,311,140
Male,348,656,85,204,23٫8,286,172,303,131
Male,348,663,89,221,24٫92,269,181,331,150
Male,349,608,91,217,25٫48,256,179,313,134
Male,349,610,87,213,24٫36,259,178,320,142
Male,349,610,90,218,25٫2,257,185,330,145
Male,349,611,84,200,23٫52,254,166,301,135
Male,349,611,87,215,24٫36,258,176,305,129
Male,349,611,89,214,24٫92,265,180,297,117
Male,349,616,87,213,24٫36,272,172,321,149
Male,349,617,87,208,24٫36,271,178,307,129
Male,349,619,93,224,26٫04,254,183,331,148
Male,349,620,81,207,22٫68,262,169,294,125
Male,349,620,85,205,23٫8,268,166,306,140
Male,349,620,92,220,25٫76,256,184,316,132
Male,349,621,88,209,24٫64,261,177,308,131
Male,349,622,88,210,24٫64,262,177,296,119
Male,349,622,89,213,24٫92,266,178,306,128
Male,349,624,84,207,23٫52,263,183,311,128
Male,349,624,87,210,24٫36,267,175,303,128
Male,349,624,88,217,24٫64,260,187,312,125
Male,349,625,91,222,25٫48,257,185,328,143
Male,349,626,89,215,24٫92,265,184,325,141
Male,349,626,89,222,24٫92,272,182,319,137
Male,349,626,92,224,25٫76,263,190,321,131
Male,349,626,94,223,26٫32,269,183,323,140
Male,349,627,94,226,26٫32,271,185,327,142
Male,349,629,90,212,25٫2,279,168,305,137
Male,349,629,92,218,25٫76,264,172,293,121
Male,349,630,86,208,24٫08,270,184,314,130
Male,349,631,88,206,24٫64,270,176,305,129
Male,349,632,88,206,24٫64,269,166,300,134
Male,349,632,88,212,24٫64,270,174,311,137
Male,349,632,94,224,26٫32,269,184,322,138
Male,349,633,88,221,24٫64,270,184,302,118
Male,349,633,92,220,25٫76,265,179,326,147
Male,349,633,93,215,26٫04,268,173,316,143
Male,349,634,88,212,24٫64,265,176,309,133
Male,349,634,89,213,24٫92,273,168,302,134
Male,349,635,84,204,23٫52,277,171,285,114
Male,349,635,94,223,26٫32,269,181,331,150
Male,349,637,92,215,25٫76,274,172,285,113
Male,349,638,86,205,24٫08,262,162,283,121
Male,349,638,92,224,25٫76,263,184,329,145
Male,349,639,94,223,26٫32,277,190,343,153
Male,349,640,89,221,24٫92,252,187,330,143
Male,349,640,92,216,25٫76,275,175,295,120
Male,349,641,87,210,24٫36,268,180,310,130
Male,349,641,88,210,24٫64,268,180,309,129
Male,349,641,89,208,24٫92,274,186,318,132
Male,349,641,90,214,25٫2,273,175,299,124
Male,349,641,91,225,25٫48,265,190,329,139
Male,349,642,87,210,24٫36,268,184,300,116
Male,349,643,83,204,23٫24,278,170,286,116
Male,349,644,84,203,23٫52,268,173,292,119
Male,349,645,83,203,23٫24,277,162,302,140
Male,349,645,88,217,24٫64,272,176,307,131
Male,349,646,90,217,25٫2,273,175,283,108
Male,349,651,85,199,23٫8,276,177,294,117
Male,349,651,88,212,24٫64,281,175,312,137
Male,349,653,89,210,24٫92,277,172,314,142
Male,349,654,90,212,25٫2,271,180,308,128
Male,349,659,89,212,24٫92,282,171,284,113
Male,349,660,86,206,24٫08,280,165,275,110
Male,350,600,88,211,24٫64,248,184,320,136
Male,350,613,90,216,25٫2,252,175,330,155
Male,350,616,90,215,25٫2,260,172,317,145
Male,350,617,88,213,24٫64,265,184,327,143
Male,350,617,90,217,25٫2,260,176,324,148
Male,350,619,84,202,23٫52,261,175,301,126
Male,350,620,88,210,24٫64,266,175,311,136
Male,350,621,82,207,22٫96,260,175,332,157
Male,350,621,83,201,23٫24,259,166,291,125
Male,350,621,83,203,23٫24,262,171,313,142
Male,350,621,94,226,26٫32,269,190,327,137
Male,350,622,88,217,24٫64,260,179,307,128
Male,350,623,85,210,23٫8,272,176,325,149
Male,350,623,87,214,24٫36,269,171,300,129
Male,350,625,84,203,23٫52,265,180,304,124
Male,350,625,86,211,24٫08,270,170,319,149
Male,350,625,88,210,24٫64,265,170,286,116
Male,350,625,88,221,24٫64,267,179,316,137
Male,350,625,89,212,24٫92,263,174,304,130
Male,350,626,85,206,23٫8,269,167,293,126
Male,350,627,88,213,24٫64,265,177,322,145
Male,350,628,89,217,24٫92,268,180,288,108
Male,350,628,93,217,26٫04,264,176,290,114
Male,350,628,93,218,26٫04,268,178,327,149
Male,350,629,86,207,24٫08,273,184,327,143
Male,350,629,90,222,25٫2,262,188,339,151
Male,350,630,83,203,23٫24,260,166,278,112
Male,350,631,90,222,25٫2,264,186,340,154
Male,350,632,84,203,23٫52,271,173,315,142
Male,350,632,90,214,25٫2,269,177,307,130
Male,350,633,86,205,24٫08,269,176,316,140
Male,350,633,88,218,24٫64,264,181,322,141
Male,350,633,90,221,25٫2,274,175,313,138
Male,350,633,92,218,25٫76,268,164,281,117
Male,350,634,85,204,23٫8,270,166,304,138
Male,350,634,88,216,24٫64,262,176,331,155
Male,350,634,91,217,25٫48,264,178,308,130
Male,350,635,94,229,26٫32,256,180,324,144
Male,350,636,87,204,24٫36,272,171,305,134
Male,350,636,87,207,24٫36,260,174,287,113
Male,350,637,85,202,23٫8,268,167,325,158
Male,350,637,87,208,24٫36,270,173,290,117
Male,350,637,88,211,24٫64,266,176,297,121
Male,350,637,88,211,24٫64,267,175,316,141
Male,350,637,90,222,25٫2,280,189,319,130
Male,350,637,91,217,25٫48,269,168,312,144
Male,350,638,87,211,24٫36,268,176,315,139
Male,350,638,88,206,24٫64,273,175,298,123
Male,350,638,90,219,25٫2,271,180,314,134
Male,350,638,90,220,25٫2,267,189,343,154
Male,350,639,86,205,24٫08,276,166,275,109
Male,350,641,83,201,23٫24,264,171,312,141
Male,350,641,85,204,23٫8,269,170,283,113
Male,350,641,91,214,25٫48,272,177,313,136
Male,350,642,87,203,24٫36,264,164,288,124
Male,350,642,92,213,25٫76,268,176,335,159
Male,350,644,89,213,24٫92,279,172,312,140
Male,350,644,89,217,24٫92,271,171,301,130
Male,350,645,89,211,24٫92,277,178,307,129
Male,350,645,90,214,25٫2,267,181,319,138
Male,350,645,90,217,25٫2,273,180,337,157
Male,350,646,94,220,26٫32,274,179,304,125
Male,350,646,94,226,26٫32,270,174,324,150
Male,350,647,87,213,24٫36,280,176,285,109
Male,350,647,88,209,24٫64,269,170,311,141
Male,350,649,84,197,23٫52,273,175,288,113
Male,350,649,85,206,23٫8,275,172,312,140
Male,350,649,87,218,24٫36,269,180,327,147
Male,350,650,84,202,23٫52,267,169,286,117
Male,350,652,87,219,24٫36,279,182,320,138
Male,350,653,90,214,25٫2,282,181,325,144
Male,350,656,89,210,24٫92,270,172,299,127
Male,350,656,91,219,25٫48,278,176,300,124
Male,350,659,91,216,25٫48,277,173,308,135
Male,350,661,82,207,22٫96,288,171,322,151
Male,350,663,91,219,25٫48,278,175,314,139
Male,350,664,92,220,25٫76,274,180,302,122
Male,350,665,89,217,24٫92,263,172,320,148
Male,350,667,88,217,24٫64,283,182,320,138
Male,350,671,89,207,24٫92,279,163,318,155
Male,351,601,90,215,25٫2,247,175,311,136
Male,351,611,88,212,24٫64,265,172,329,157
Male,351,613,89,213,24٫92,264,180,333,153
Male,351,615,93,214,26٫04,268,183,330,147
Male,351,616,84,202,23٫52,261,170,297,127
Male,351,618,84,205,23٫52,264,171,289,118
Male,351,618,87,202,24٫36,266,177,329,152
Male,351,618,93,226,26٫04,256,180,329,149
Male,351,618,94,224,26٫32,260,178,332,154
Male,351,619,87,205,24٫36,269,166,291,125
Male,351,619,93,220,26٫04,260,181,338,157
Male,351,620,88,212,24٫64,266,171,315,144
Male,351,620,90,216,25٫2,259,176,311,135
Male,351,621,83,203,23٫24,259,182,307,125
Male,351,621,93,217,26٫04,268,180,307,127
Male,351,622,86,210,24٫08,258,179,320,141
Male,351,622,95,225,26٫6,269,190,341,151
Male,351,623,83,200,23٫24,267,165,305,140
Male,351,623,87,205,24٫36,264,181,302,121
Male,351,623,93,222,26٫04,259,178,317,139
Male,351,626,87,212,24٫36,268,187,332,145
Male,351,626,92,226,25٫76,264,187,335,148
Male,351,627,88,210,24٫64,274,173,322,149
Male,351,627,90,213,25٫2,271,180,295,115
Male,351,628,81,197,22٫68,275,164,287,123
Male,351,628,90,221,25٫2,263,184,305,121
Male,351,629,86,205,24٫08,256,172,303,131
Male,351,629,91,215,25٫48,264,179,322,143
Male,351,630,90,218,25٫2,278,173,322,149
Male,351,631,89,211,24٫92,262,178,295,117
Male,351,632,86,205,24٫08,274,171,302,131
Male,351,632,91,217,25٫48,267,180,318,138
Male,351,633,90,212,25٫2,267,180,325,145
Male,351,633,91,217,25٫48,267,186,336,150
Male,351,633,92,215,25٫76,271,165,319,154
Male,351,634,88,217,24٫64,271,181,343,162
Male,351,635,89,220,24٫92,267,175,334,159
Male,351,635,92,218,25٫76,264,186,325,139
Male,351,637,82,197,22٫96,272,166,297,131
Male,351,637,88,213,24٫64,275,174,329,155
Male,351,638,82,206,22٫96,274,180,307,127
Male,351,638,83,198,23٫24,277,170,320,150
Male,351,638,86,207,24٫08,271,173,292,119
Male,351,639,85,202,23٫8,277,170,301,131
Male,351,639,87,213,24٫36,270,185,325,140
Male,351,640,88,212,24٫64,278,170,294,124
Male,351,640,91,220,25٫48,270,183,343,160
Male,351,641,92,224,25٫76,274,187,320,133
Male,351,643,90,216,25٫2,269,176,318,142
Male,351,644,94,220,26٫32,279,183,310,127
Male,351,644,96,227,26٫88,271,176,328,152
Male,351,645,84,207,23٫52,262,179,299,120
Male,351,646,88,210,24٫64,276,180,330,150
Male,351,647,89,212,24٫92,282,177,287,110
Male,351,648,95,228,26٫6,271,179,318,139
Male,351,650,88,213,24٫64,272,177,289,112
Male,351,650,88,217,24٫64,267,185,301,116
Male,351,650,90,215,25٫2,273,184,333,149
Male,351,655,91,216,25٫48,270,183,300,117
Male,351,657,84,198,23٫52,270,170,281,111
Male,351,657,88,214,24٫64,274,180,303,123
Male,351,659,86,214,24٫08,272,182,316,134
Male,351,660,89,214,24٫92,282,177,297,120
Male,351,664,85,207,23٫8,276,174,295,121
Male,352,588,81,200,22٫68,255,167,288,121
Male,352,601,83,200,23٫24,260,170,303,133
Male,352,605,85,207,23٫8,248,168,280,112
Male,352,606,87,205,24٫36,264,176,306,130
Male,352,612,92,215,25٫76,262,177,298,121
Male,352,613,88,208,24٫64,266,176,307,131
Male,352,616,90,213,25٫2,248,173,299,126
Male,352,617,84,201,23٫52,269,168,301,133
Male,352,619,83,205,23٫24,259,176,299,123
Male,352,620,89,212,24٫92,261,175,306,131
Male,352,621,90,214,25٫2,263,182,339,157
Male,352,622,87,212,24٫36,270,181,327,146
Male,352,625,85,207,23٫8,264,170,288,118
Male,352,625,91,215,25٫48,264,176,310,134
Male,352,627,91,218,25٫48,264,163,302,139
Male,352,627,94,223,26٫32,268,181,336,155
Male,352,627,95,225,26٫6,263,176,308,132
Male,352,628,89,210,24٫92,268,170,326,156
Male,352,630,89,215,24٫92,269,178,338,160
Male,352,630,91,220,25٫48,266,182,306,124
Male,352,631,87,213,24٫36,263,182,337,155
Male,352,631,88,214,24٫64,267,180,316,136
Male,352,631,90,210,25٫2,273,182,325,143
Male,352,631,94,228,26٫32,264,182,335,153
Male,352,632,90,215,25٫2,275,178,336,158
Male,352,634,84,207,23٫52,267,180,311,131
Male,352,634,94,217,26٫32,271,182,317,135
Male,352,635,85,208,23٫8,267,179,317,138
Male,352,635,90,218,25٫2,274,187,329,142
Male,352,635,91,213,25٫48,273,167,297,130
Male,352,635,91,221,25٫48,269,179,316,137
Male,352,636,85,210,23٫8,270,175,329,154
Male,352,636,87,204,24٫36,267,181,314,133
Male,352,636,93,222,26٫04,266,179,309,130
Male,352,637,86,207,24٫08,276,174,289,115
Male,352,637,88,205,24٫64,265,169,289,120
Male,352,637,88,212,24٫64,265,180,335,155
Male,352,638,85,212,23٫8,274,174,301,127
Male,352,639,91,212,25٫48,267,183,296,113
Male,352,639,91,214,25٫48,278,173,288,115
Male,352,640,89,212,24٫92,274,178,306,128
Male,352,641,89,218,24٫92,266,181,316,135
Male,352,642,86,208,24٫08,280,177,308,131
Male,352,644,86,212,24٫08,269,180,322,142
Male,352,644,88,208,24٫64,280,181,310,129
Male,352,644,88,212,24٫64,263,176,312,136
Male,352,646,87,206,24٫36,269,175,298,123
Male,352,646,91,220,25٫48,275,174,308,134
Male,352,647,84,197,23٫52,280,165,308,143
Male,352,649,86,205,24٫08,274,176,295,119
Male,352,649,90,216,25٫2,277,178,334,156
Male,352,650,90,210,25٫2,278,172,301,129
Male,352,650,91,216,25٫48,279,172,323,151
Male,352,650,92,219,25٫76,269,182,329,147
Male,352,650,92,221,25٫76,263,187,326,139
Male,352,653,82,202,22٫96,272,169,290,121
Male,352,655,87,212,24٫36,281,174,317,143
Male,352,657,90,217,25٫2,278,180,294,114
Male,352,658,83,200,23٫24,282,174,304,130
Male,352,660,85,207,23٫8,278,181,297,116
Male,352,662,86,209,24٫08,278,170,286,116
Male,352,663,86,212,24٫08,277,168,307,139
Male,352,664,88,210,24٫64,274,178,295,117
Male,353,598,89,210,24٫92,254,170,310,140
Male,353,606,88,217,24٫64,255,185,341,156
Male,353,607,81,196,22٫68,269,168,307,139
Male,353,608,91,221,25٫48,261,181,309,128
Male,353,612,94,219,26٫32,256,177,326,149
Male,353,617,85,205,23٫8,262,170,291,121
Male,353,618,93,228,26٫04,267,182,322,140
Male,353,619,93,223,26٫04,263,182,313,131
Male,353,619,93,224,26٫04,264,187,340,153
Male,353,620,86,205,24٫08,264,171,307,136
Male,353,620,88,211,24٫64,262,179,292,113
Male,353,620,89,217,24٫92,263,174,307,133
Male,353,621,85,208,23٫8,266,176,293,117
Male,353,621,90,216,25٫2,263,174,298,124
Male,353,622,84,197,23٫52,265,171,313,142
Male,353,624,90,215,25٫2,267,174,305,131
Male,353,624,92,216,25٫76,266,174,314,140
Male,353,626,90,214,25٫2,277,178,325,147
Male,353,626,92,219,25٫76,269,170,291,121
Male,353,627,88,217,24٫64,268,179,302,123
Male,353,628,86,211,24٫08,266,180,325,145
Male,353,628,88,209,24٫64,265,175,314,139
Male,353,628,94,226,26٫32,260,177,327,150
Male,353,629,94,217,26٫32,272,187,333,146
Male,353,632,88,211,24٫64,254,171,300,129
Male,353,632,94,230,26٫32,267,179,328,149
Male,353,634,90,223,25٫2,261,185,313,128
Male,353,634,92,225,25٫76,259,188,328,140
Male,353,636,93,226,26٫04,270,181,324,143
Male,353,636,93,227,26٫04,266,189,327,138
Male,353,637,88,213,24٫64,272,175,320,145
Male,353,637,88,216,24٫64,261,171,319,148
Male,353,637,93,227,26٫04,273,188,344,156
Male,353,638,82,200,22٫96,268,167,314,147
Male,353,638,87,218,24٫36,272,174,290,116
Male,353,638,89,216,24٫92,279,183,344,161
Male,353,640,94,222,26٫32,269,174,313,139
Male,353,641,85,198,23٫8,280,167,280,113
Male,353,641,87,215,24٫36,262,176,322,146
Male,353,641,91,215,25٫48,271,174,300,126
Male,353,641,91,216,25٫48,278,173,309,136
Male,353,642,83,203,23٫24,275,164,280,116
Male,353,644,89,211,24٫92,273,183,332,149
Male,353,644,89,221,24٫92,276,183,322,139
Male,353,644,90,224,25٫2,270,177,322,145
Male,353,645,87,215,24٫36,274,178,322,144
Male,353,647,81,202,22٫68,272,167,280,113
Male,353,647,89,214,24٫92,283,182,319,137
Male,353,647,94,223,26٫32,276,179,298,119
Male,353,647,95,222,26٫6,289,172,334,162
Male,353,648,94,220,26٫32,275,177,310,133
Male,353,649,89,218,24٫92,270,174,286,112
Male,353,650,90,212,25٫2,279,172,318,146
Male,353,651,88,207,24٫64,278,173,297,124
Male,353,651,88,217,24٫64,270,168,306,138
Male,353,651,94,223,26٫32,268,184,324,140
Male,353,652,87,213,24٫36,271,170,296,126
Male,353,653,91,218,25٫48,276,179,315,136
Male,353,655,85,210,23٫8,279,171,322,151
Male,353,656,90,217,25٫2,272,180,320,140
Male,353,656,91,214,25٫48,267,180,314,134
Male,353,657,86,209,24٫08,280,178,287,109
Male,353,665,84,205,23٫52,282,171,284,113
Male,353,667,92,218,25٫76,287,174,301,127
Male,354,607,92,219,25٫76,264,184,322,138
Male,354,609,85,212,23٫8,263,168,279,111
Male,354,611,84,205,23٫52,254,166,300,134
Male,354,616,91,223,25٫48,262,187,327,140
Male,354,616,94,230,26٫32,265,184,339,155
Male,354,617,89,215,24٫92,258,180,312,132
Male,354,619,86,203,24٫08,259,173,313,140
Male,354,622,85,207,23٫8,262,175,323,148
Male,354,622,95,227,26٫6,265,188,332,144
Male,354,623,86,212,24٫08,262,178,315,137
Male,354,625,87,216,24٫36,275,186,333,147
Male,354,627,83,200,23٫24,269,167,312,145
Male,354,627,85,202,23٫8,268,170,278,108
Male,354,627,85,208,23٫8,261,178,297,119
Male,354,630,89,214,24٫92,258,175,288,113
Male,354,631,81,204,22٫68,274,173,303,130
Male,354,631,83,207,23٫24,274,171,307,136
Male,354,631,84,200,23٫52,282,165,302,137
Male,354,631,90,214,25٫2,272,184,324,140
Male,354,631,91,217,25٫48,260,180,320,140
Male,354,632,86,200,24٫08,268,164,303,139
Male,354,633,84,203,23٫52,266,168,296,128
Male,354,633,86,213,24٫08,268,175,309,134
Male,354,633,95,225,26٫6,272,180,320,140
Male,354,635,86,210,24٫08,272,175,307,132
Male,354,635,94,226,26٫32,278,182,316,134
Male,354,636,83,200,23٫24,265,162,299,137
Male,354,636,85,208,23٫8,276,168,304,136
Male,354,636,87,207,24٫36,278,174,310,136
Male,354,636,94,221,26٫32,263,184,327,143
Male,354,637,83,197,23٫24,277,174,287,113
Male,354,638,81,204,22٫68,275,167,277,110
Male,354,638,86,211,24٫08,273,172,306,134
Male,354,638,88,213,24٫64,274,181,305,124
Male,354,639,88,208,24٫64,271,177,296,119
Male,354,639,92,213,25٫76,280,167,309,142
Male,354,639,93,224,26٫04,268,179,322,143
Male,354,639,94,221,26٫32,270,187,336,149
Male,354,640,85,204,23٫8,284,178,340,162
Male,354,640,91,216,25٫48,278,190,313,123
Male,354,642,86,207,24٫08,274,173,313,140
Male,354,642,88,217,24٫64,263,181,322,141
Male,354,642,90,215,25٫2,270,180,309,129
Male,354,642,90,223,25٫2,267,182,304,122
Male,354,642,92,221,25٫76,267,175,298,123
Male,354,643,85,205,23٫8,275,172,289,117
Male,354,643,91,227,25٫48,264,182,319,137
Male,354,644,83,208,23٫24,269,174,315,141
Male,354,644,88,207,24٫64,277,165,297,132
Male,354,644,88,220,24٫64,267,183,338,155
Male,354,644,91,211,25٫48,277,172,323,151
Male,354,644,93,223,26٫04,267,183,322,139
Male,354,645,85,213,23٫8,267,178,331,153
Male,354,646,86,212,24٫08,272,179,335,156
Male,354,646,89,209,24٫92,282,171,317,146
Male,354,646,90,213,25٫2,271,177,321,144
Male,354,647,86,210,24٫08,276,180,304,124
Male,354,647,86,212,24٫08,271,184,330,146
Male,354,647,87,210,24٫36,275,175,300,125
Male,354,647,88,218,24٫64,280,187,346,159
Male,354,647,90,217,25٫2,278,178,304,126
Male,354,648,87,203,24٫36,272,181,311,130
Male,354,650,88,210,24٫64,277,175,315,140
Male,354,650,92,222,25٫76,275,182,300,118
Male,354,651,87,207,24٫36,264,174,297,123
Male,354,652,85,209,23٫8,265,170,289,119
Male,354,654,85,201,23٫8,272,168,295,127
Male,354,654,90,214,25٫2,273,173,321,148
Male,354,655,91,220,25٫48,279,187,344,157
Male,354,656,86,210,24٫08,278,178,301,123
Male,354,657,84,200,23٫52,273,171,284,113
Male,354,657,93,222,26٫04,278,183,336,153
Male,354,658,87,211,24٫36,293,171,318,147
Male,354,658,87,217,24٫36,267,178,337,159
Male,354,658,89,215,24٫92,269,176,329,153
Male,354,658,91,215,25٫48,278,178,310,132
Male,354,663,93,220,26٫04,280,181,329,148
Male,354,667,82,204,22٫96,272,177,297,120
Male,354,672,89,213,24٫92,276,171,303,132
Male,354,684,84,205,23٫52,288,177,328,151
Male,355,597,88,211,24٫64,257,172,323,151
Male,355,599,88,218,24٫64,251,179,319,140
Male,355,599,94,224,26٫32,260,185,323,138
Male,355,601,94,230,26٫32,251,189,311,122
Male,355,611,90,216,25٫2,262,177,327,150
Male,355,616,89,208,24٫92,257,178,298,120
Male,355,617,86,207,24٫08,256,180,323,143
Male,355,617,86,207,24٫08,272,169,308,139
Male,355,617,92,223,25٫76,271,185,320,135
Male,355,621,90,217,25٫2,255,178,314,136
Male,355,622,88,213,24٫64,267,185,324,139
Male,355,622,93,222,26٫04,275,178,320,142
Male,355,623,87,210,24٫36,261,175,308,133
Male,355,625,90,223,25٫2,268,183,311,128
Male,355,625,93,219,26٫04,266,174,309,135
Male,355,626,90,217,25٫2,264,182,312,130
Male,355,627,94,227,26٫32,268,184,325,141
Male,355,628,81,201,22٫68,274,174,290,116
Male,355,628,87,217,24٫36,264,171,287,116
Male,355,628,88,212,24٫64,268,182,319,137
Male,355,629,86,203,24٫08,272,167,307,140
Male,355,629,88,214,24٫64,261,185,318,133
Male,355,629,90,225,25٫2,266,182,329,147
Male,355,631,86,207,24٫08,269,166,300,134
Male,355,631,88,215,24٫64,264,186,312,126
Male,355,631,91,213,25٫48,266,183,306,123
Male,355,632,86,211,24٫08,267,172,301,129
Male,355,632,88,221,24٫64,270,183,321,138
Male,355,632,93,214,26٫04,268,173,305,132
Male,355,635,84,205,23٫52,268,171,297,126
Male,355,635,84,207,23٫52,261,177,309,132
Male,355,636,88,217,24٫64,271,183,337,154
Male,355,636,90,227,25٫2,262,181,292,111
Male,355,636,93,222,26٫04,264,179,299,120
Male,355,637,88,213,24٫64,262,175,305,130
Male,355,638,86,207,24٫08,272,169,291,122
Male,355,638,88,216,24٫64,270,175,291,116
Male,355,639,87,212,24٫36,277,184,315,131
Male,355,639,88,214,24٫64,270,174,307,133
Male,355,639,90,217,25٫2,275,179,323,144
Male,355,639,92,219,25٫76,272,183,326,143
Male,355,640,88,208,24٫64,271,174,284,110
Male,355,640,91,222,25٫48,270,190,334,144
Male,355,642,89,211,24٫92,263,174,301,127
Male,355,643,84,208,23٫52,272,172,301,129
Male,355,644,87,212,24٫36,280,180,307,127
Male,355,644,91,213,25٫48,269,175,326,151
Male,355,644,92,228,25٫76,279,180,332,152
Male,355,644,93,222,26٫04,268,184,324,140
Male,355,645,92,222,25٫76,288,165,325,160
Male,355,645,95,224,26٫6,268,185,322,137
Male,355,646,86,211,24٫08,281,171,308,137
Male,355,648,86,212,24٫08,271,176,330,154
Male,355,648,87,215,24٫36,273,181,308,127
Male,355,648,88,208,24٫64,277,169,309,140
Male,355,649,88,212,24٫64,267,175,302,127
Male,355,649,88,222,24٫64,275,174,312,138
Male,355,650,90,213,25٫2,277,175,286,111
Male,355,650,93,220,26٫04,274,179,309,130
Male,355,650,94,227,26٫32,278,185,309,124
Male,355,651,90,215,25٫2,271,184,319,135
Male,355,651,94,227,26٫32,274,183,345,162
Male,355,652,90,222,25٫2,271,185,318,133
Male,355,652,92,220,25٫76,273,184,338,154
Male,355,653,83,200,23٫24,276,173,300,127
Male,355,653,84,205,23٫52,271,181,317,136
Male,355,653,87,213,24٫36,282,174,316,142
Male,355,653,90,213,25٫2,276,176,302,126
Male,355,653,94,223,26٫32,283,182,326,144
Male,355,654,83,200,23٫24,281,170,302,132
Male,355,654,85,215,23٫8,275,184,310,126
Male,355,654,91,214,25٫48,277,180,294,114
Male,355,655,87,205,24٫36,278,177,309,132
Male,355,655,89,210,24٫92,285,170,306,136
Male,355,657,90,222,25٫2,279,182,300,118
Male,355,659,88,213,24٫64,283,183,314,131
Male,355,661,88,212,24٫64,274,178,310,132
Male,355,661,92,228,25٫76,269,188,332,144
Male,355,662,88,215,24٫64,275,175,299,124
Male,355,670,89,211,24٫92,282,173,304,131
Male,355,673,87,206,24٫36,280,171,302,131
Male,355,683,87,212,24٫36,289,186,331,145
Male,356,611,88,212,24٫64,249,176,314,138
Male,356,616,90,212,25٫2,276,172,304,132
Male,356,622,85,201,23٫8,267,174,307,133
Male,356,626,89,209,24٫92,260,180,334,154
Male,356,626,89,211,24٫92,267,170,313,143
Male,356,629,87,202,24٫36,276,168,279,111
Male,356,630,89,210,24٫92,277,173,325,152
Male,356,630,95,228,26٫6,273,180,311,131
Male,356,631,87,208,24٫36,270,183,295,112
Male,356,632,87,211,24٫36,263,180,342,162
Male,356,632,93,227,26٫04,264,181,306,125
Male,356,633,88,220,24٫64,261,179,327,148
Male,356,633,91,216,25٫48,273,182,326,144
Male,356,633,95,222,26٫6,265,174,320,146
Male,356,634,87,204,24٫36,275,173,311,138
Male,356,634,94,226,26٫32,266,191,347,156
Male,356,635,84,207,23٫52,268,175,284,109
Male,356,635,89,223,24٫92,271,190,335,145
Male,356,636,90,216,25٫2,273,180,315,135
Male,356,636,91,218,25٫48,265,182,338,156
Male,356,637,86,203,24٫08,281,170,317,147
Male,356,638,90,215,25٫2,281,177,326,149
Male,356,638,92,218,25٫76,265,186,326,140
Male,356,640,89,215,24٫92,271,176,303,127
Male,356,641,84,206,23٫52,266,180,313,133
Male,356,641,93,227,26٫04,268,183,330,147
Male,356,642,89,221,24٫92,267,176,314,138
Male,356,642,91,215,25٫48,275,175,306,131
Male,356,643,92,220,25٫76,268,190,332,142
Male,356,643,93,221,26٫04,281,178,288,110
Male,356,644,90,212,25٫2,275,178,333,155
Male,356,645,87,212,24٫36,265,173,300,127
Male,356,645,90,215,25٫2,276,183,319,136
Male,356,646,87,207,24٫36,278,167,281,114
Male,356,646,88,207,24٫64,275,169,304,135
Male,356,646,88,220,24٫64,282,181,309,128
Male,356,646,92,220,25٫76,266,173,311,138
Male,356,646,93,217,26٫04,277,179,312,133
Male,356,646,93,226,26٫04,280,174,297,123
Male,356,647,87,211,24٫36,276,177,323,146
Male,356,647,88,217,24٫64,269,183,306,123
Male,356,647,88,218,24٫64,272,175,298,123
Male,356,648,85,205,23٫8,280,173,314,141
Male,356,648,88,209,24٫64,279,176,300,124
Male,356,648,91,218,25٫48,280,173,300,127
Male,356,649,87,214,24٫36,280,177,327,150
Male,356,649,91,216,25٫48,267,178,313,135
Male,356,649,92,223,25٫76,277,187,341,154
Male,356,650,92,219,25٫76,276,175,298,123
Male,356,651,92,217,25٫76,273,175,313,138
Male,356,652,92,219,25٫76,272,187,324,137
Male,356,655,89,207,24٫92,284,171,322,151
Male,356,655,89,212,24٫92,276,174,309,135
Male,356,655,89,215,24٫92,271,182,314,132
Male,356,655,89,221,24٫92,274,175,336,161
Male,356,657,84,207,23٫52,274,179,291,112
Male,356,658,96,226,26٫88,277,178,308,130
Male,356,660,92,228,25٫76,286,181,323,142
Male,356,664,89,210,24٫92,282,176,288,112
Male,356,665,85,215,23٫8,271,177,310,133
Male,356,665,92,222,25٫76,282,177,291,114
Male,356,666,93,223,26٫04,286,184,311,127
Male,356,669,89,210,24٫92,283,173,292,119
Male,356,670,93,226,26٫04,274,179,340,161
Male,356,672,87,211,24٫36,290,176,322,146
Male,356,672,95,222,26٫6,283,185,320,135
Male,356,675,86,205,24٫08,282,173,312,139
Male,356,682,87,213,24٫36,288,186,313,127
Male,357,613,88,213,24٫64,256,175,322,147
Male,357,619,89,214,24٫92,254,174,312,138
Male,357,619,91,212,25٫48,274,177,319,142
Male,357,620,86,206,24٫08,280,182,320,138
Male,357,620,88,212,24٫64,270,167,299,132
Male,357,620,90,213,25٫2,255,188,313,125
Male,357,621,86,202,24٫08,262,172,305,133
Male,357,622,85,200,23٫8,261,168,295,127
Male,357,622,92,221,25٫76,270,170,296,126
Male,357,623,88,222,24٫64,271,170,326,156
Male,357,626,84,203,23٫52,280,177,312,135
Male,357,626,89,211,24٫92,271,174,306,132
Male,357,626,89,224,24٫92,265,180,307,127
Male,357,626,91,215,25٫48,268,178,323,145
Male,357,627,91,218,25٫48,263,174,319,145
Male,357,628,86,207,24٫08,280,180,299,119
Male,357,629,86,203,24٫08,276,171,300,129
Male,357,632,95,222,26٫6,274,168,314,146
Male,357,633,84,209,23٫52,270,184,320,136
Male,357,633,93,224,26٫04,267,184,331,147
Male,357,634,84,199,23٫52,274,172,307,135
Male,357,634,90,212,25٫2,263,171,307,136
Male,357,634,90,213,25٫2,276,174,312,138
Male,357,635,93,216,26٫04,279,178,292,114
Male,357,636,89,212,24٫92,266,179,319,140
Male,357,636,95,217,26٫6,274,186,301,115
Male,357,637,92,217,25٫76,272,168,300,132
Male,357,638,88,214,24٫64,277,174,292,118
Male,357,638,92,225,25٫76,270,177,319,142
Male,357,639,88,207,24٫64,275,171,298,127
Male,357,640,84,201,23٫52,271,166,290,124
Male,357,642,87,208,24٫36,274,182,317,135
Male,357,642,90,220,25٫2,279,178,331,153
Male,357,643,87,207,24٫36,273,177,297,120
Male,357,643,87,213,24٫36,269,173,302,129
Male,357,643,89,216,24٫92,273,185,326,141
Male,357,644,82,197,22٫96,278,168,287,119
Male,357,644,87,218,24٫36,269,186,317,131
Male,357,645,86,211,24٫08,268,172,302,130
Male,357,645,88,213,24٫64,283,180,303,123
Male,357,645,90,213,25٫2,270,173,284,111
Male,357,646,90,224,25٫2,278,181,320,139
Male,357,647,83,211,23٫24,273,178,323,145
Male,357,648,89,211,24٫92,265,175,291,116
Male,357,649,85,208,23٫8,275,179,332,153
Male,357,649,93,216,26٫04,279,183,301,118
Male,357,650,91,213,25٫48,277,182,344,162
Male,357,651,85,204,23٫8,284,167,315,148
Male,357,651,85,207,23٫8,283,167,305,138
Male,357,651,92,222,25٫76,275,180,307,127
Male,357,652,88,220,24٫64,269,181,322,141
Male,357,654,87,212,24٫36,277,171,302,131
Male,357,655,90,218,25٫2,278,185,323,138
Male,357,656,84,199,23٫52,273,163,291,128
Male,357,656,91,214,25٫48,281,177,308,131
Male,357,664,85,203,23٫8,280,165,283,118
Male,357,664,87,207,24٫36,272,180,329,149
Male,357,666,93,218,26٫04,279,180,317,137
Male,357,667,93,220,26٫04,276,178,323,145
Male,357,671,91,222,25٫48,279,187,331,144
Male,357,672,87,210,24٫36,282,181,306,125
Male,357,672,89,211,24٫92,284,173,283,110
Male,357,680,90,217,25٫2,280,173,281,108
Male,358,592,87,205,24٫36,252,172,333,161
Male,358,595,91,213,25٫48,257,178,294,116
Male,358,608,93,215,26٫04,254,186,335,149
Male,358,610,88,208,24٫64,266,168,280,112
Male,358,611,91,220,25٫48,262,179,322,143
Male,358,615,93,222,26٫04,260,179,294,115
Male,358,616,84,198,23٫52,272,164,277,113
Male,358,619,93,226,26٫04,256,191,344,153
Male,358,620,88,210,24٫64,273,183,305,122
Male,358,624,88,217,24٫64,260,183,332,149
Male,358,624,91,216,25٫48,265,181,324,143
Male,358,626,88,212,24٫64,270,178,331,153
Male,358,627,87,207,24٫36,275,168,294,126
Male,358,627,94,228,26٫32,272,190,316,126
Male,358,628,93,220,26٫04,268,181,302,121
Male,358,629,89,213,24٫92,269,178,304,126
Male,358,629,90,214,25٫2,272,184,333,149
Male,358,630,87,214,24٫36,273,173,296,123
Male,358,631,92,223,25٫76,272,185,320,135
Male,358,631,92,225,25٫76,266,185,343,158
Male,358,632,90,218,25٫2,257,185,326,141
Male,358,633,94,227,26٫32,269,187,334,147
Male,358,637,84,211,23٫52,275,177,300,123
Male,358,637,87,214,24٫36,275,186,324,138
Male,358,637,90,219,25٫2,271,172,321,149
Male,358,638,88,211,24٫64,273,165,295,130
Male,358,638,89,217,24٫92,268,184,327,143
Male,358,639,86,210,24٫08,278,175,310,135
Male,358,639,89,205,24٫92,277,171,291,120
Male,358,639,91,217,25٫48,274,181,316,135
Male,358,640,89,218,24٫92,270,180,322,142
Male,358,642,85,208,23٫8,278,171,305,134
Male,358,642,92,223,25٫76,282,173,315,142
Male,358,644,87,213,24٫36,285,170,297,127
Male,358,644,90,217,25٫2,284,177,329,152
Male,358,644,93,226,26٫04,271,185,324,139
Male,358,645,87,208,24٫36,278,175,319,144
Male,358,645,90,217,25٫2,280,183,315,132
Male,358,648,88,213,24٫64,279,185,324,139
Male,358,648,92,223,25٫76,275,175,299,124
Male,358,649,85,206,23٫8,280,175,297,122
Male,358,649,91,220,25٫48,272,181,328,147
Male,358,649,93,218,26٫04,287,185,314,129
Male,358,650,89,218,24٫92,284,184,313,129
Male,358,650,90,217,25٫2,276,187,323,136
Male,358,651,83,197,23٫24,274,168,287,119
Male,358,651,84,204,23٫52,281,174,309,135
Male,358,651,92,228,25٫76,272,184,319,135
Male,358,651,93,227,26٫04,274,180,320,140
Male,358,652,83,206,23٫24,277,175,291,116
Male,358,653,88,212,24٫64,273,178,299,121
Male,358,654,88,215,24٫64,278,170,321,151
Male,358,656,88,216,24٫64,280,179,314,135
Male,358,658,87,209,24٫36,279,184,300,116
Male,358,658,90,218,25٫2,274,175,283,108
Male,358,659,85,206,23٫8,271,175,301,126
Male,358,661,87,208,24٫36,278,178,302,124
Male,358,662,89,216,24٫92,280,175,292,117
Male,358,662,90,213,25٫2,276,173,308,135
Male,358,662,92,217,25٫76,273,188,342,154
Male,358,662,92,223,25٫76,280,188,346,158
Male,358,665,84,209,23٫52,285,166,313,147
Male,358,666,88,207,24٫64,278,167,294,127
Male,358,667,83,206,23٫24,285,170,302,132
Male,358,667,88,216,24٫64,278,187,335,148
Male,358,670,90,217,25٫2,287,170,290,120
Male,358,671,89,212,24٫92,274,190,328,138
Male,358,679,90,215,25٫2,280,166,281,115
Male,358,683,92,219,25٫76,287,180,307,127
Male,359,605,89,212,24٫92,275,172,320,148
Male,359,611,88,214,24٫64,265,184,306,122
Male,359,621,86,211,24٫08,274,177,313,136
Male,359,625,86,206,24٫08,262,175,288,113
Male,359,625,89,210,24٫92,264,172,306,134
Male,359,626,87,210,24٫36,270,169,315,146
Male,359,629,86,203,24٫08,277,168,302,134
Male,359,631,93,222,26٫04,273,179,321,142
Male,359,632,85,203,23٫8,273,177,287,110
Male,359,633,92,226,25٫76,264,168,293,125
Male,359,635,84,207,23٫52,272,175,292,117
Male,359,636,88,216,24٫64,272,175,314,139
Male,359,636,89,216,24٫92,264,178,316,138
Male,359,636,90,210,25٫2,275,167,303,136
Male,359,636,93,221,26٫04,270,183,319,136
Male,359,637,93,220,26٫04,276,186,331,145
Male,359,638,91,221,25٫48,272,175,306,131
Male,359,639,89,217,24٫92,274,167,292,125
Male,359,639,90,215,25٫2,264,185,322,137
Male,359,640,87,214,24٫36,272,175,336,161
Male,359,642,89,215,24٫92,272,182,322,140
Male,359,642,92,224,25٫76,280,171,298,127
Male,359,643,94,226,26٫32,268,176,300,124
Male,359,644,81,202,22٫68,276,168,311,143
Male,359,644,87,211,24٫36,275,164,278,114
Male,359,644,92,222,25٫76,284,173,314,141
Male,359,645,88,211,24٫64,277,176,306,130
Male,359,645,89,210,24٫92,268,182,317,135
Male,359,646,86,207,24٫08,275,177,316,139
Male,359,647,90,217,25٫2,272,174,305,131
Male,359,647,92,223,25٫76,284,173,294,121
Male,359,648,88,212,24٫64,267,180,292,112
Male,359,648,89,210,24٫92,279,183,327,144
Male,359,648,91,220,25٫48,274,182,322,140
Male,359,648,91,221,25٫48,279,182,324,142
Male,359,650,84,203,23٫52,288,162,290,128
Male,359,650,92,221,25٫76,277,184,310,126
Male,359,651,86,210,24٫08,274,171,298,127
Male,359,651,86,211,24٫08,276,178,311,133
Male,359,652,83,213,23٫24,279,173,303,130
Male,359,652,84,200,23٫52,285,172,292,120
Male,359,652,89,214,24٫92,267,174,307,133
Male,359,653,85,210,23٫8,270,182,331,149
Male,359,654,87,212,24٫36,277,179,325,146
Male,359,654,92,218,25٫76,276,190,330,140
Male,359,656,88,212,24٫64,284,173,310,137
Male,359,656,88,216,24٫64,274,174,314,140
Male,359,656,92,218,25٫76,270,184,314,130
Male,359,656,93,217,26٫04,282,179,287,108
Male,359,656,94,229,26٫32,277,180,309,129
Male,359,658,91,219,25٫48,278,183,325,142
Male,359,659,91,215,25٫48,283,186,307,121
Male,359,660,90,214,25٫2,269,180,313,133
Male,359,660,90,217,25٫2,274,178,322,144
Male,359,662,87,210,24٫36,275,170,300,130
Male,359,663,94,226,26٫32,282,182,298,116
Male,359,663,96,225,26٫88,281,190,335,145
Male,359,664,88,208,24٫64,275,167,296,129
Male,359,664,88,223,24٫64,272,188,321,133
Male,359,666,91,217,25٫48,274,191,331,140
Male,359,668,92,220,25٫76,270,191,328,137
Male,359,668,92,222,25٫76,281,183,324,141
Male,359,669,90,225,25٫2,279,180,319,139
Male,359,685,85,205,23٫8,286,175,305,130
Male,360,608,86,210,24٫08,261,174,306,132
Male,360,611,84,211,23٫52,264,166,314,148
Male,360,614,93,222,26٫04,280,179,326,147
Male,360,622,86,217,24٫08,272,177,295,118
Male,360,628,93,225,26٫04,261,186,342,156
Male,360,631,93,215,26٫04,264,174,296,122
Male,360,632,90,220,25٫2,274,184,340,156
Male,360,633,90,218,25٫2,270,179,297,118
Male,360,634,85,202,23٫8,270,178,302,124
Male,360,634,85,205,23٫8,264,167,315,148
Male,360,635,85,206,23٫8,275,168,307,139
Male,360,635,96,224,26٫88,280,177,302,125
Male,360,636,85,208,23٫8,273,171,293,122
Male,360,637,87,212,24٫36,268,183,299,116
Male,360,638,88,216,24٫64,275,183,327,144
Male,360,639,90,218,25٫2,277,173,326,153
Male,360,641,90,215,25٫2,274,180,341,161
Male,360,642,87,209,24٫36,277,175,301,126
Male,360,642,89,215,24٫92,273,178,308,130
Male,360,642,90,218,25٫2,274,176,305,129
Male,360,642,94,228,26٫32,281,185,334,149
Male,360,645,92,208,25٫76,275,183,308,125
Male,360,645,92,220,25٫76,273,178,330,152
Male,360,646,86,212,24٫08,284,182,322,140
Male,360,646,89,208,24٫92,273,172,314,142
Male,360,646,91,222,25٫48,268,177,295,118
Male,360,646,93,227,26٫04,267,190,339,149
Male,360,647,91,220,25٫48,276,184,312,128
Male,360,648,94,228,26٫32,268,185,331,146
Male,360,649,93,216,26٫04,289,176,295,119
Male,360,650,88,217,24٫64,270,178,316,138
Male,360,650,90,216,25٫2,279,179,335,156
Male,360,650,90,217,25٫2,273,182,296,114
Male,360,651,90,212,25٫2,272,183,322,139
Male,360,651,92,222,25٫76,274,178,314,136
Male,360,654,85,203,23٫8,268,171,305,134
Male,360,654,90,216,25٫2,278,181,296,115
Male,360,658,93,216,26٫04,283,172,316,144
Male,360,659,88,215,24٫64,291,172,305,133
Male,360,659,94,225,26٫32,274,185,345,160
Male,360,659,95,220,26٫6,275,172,288,116
Male,360,660,87,209,24٫36,271,177,307,130
Male,360,660,87,214,24٫36,285,187,337,150
Male,360,661,90,220,25٫2,290,180,336,156
Male,360,669,86,206,24٫08,288,168,290,122
Male,360,670,88,205,24٫64,286,163,297,134
Male,360,670,91,217,25٫48,294,174,308,134
Male,360,671,87,204,24٫36,288,173,293,120
Male,360,671,88,215,24٫64,275,180,315,135
Male,360,671,91,219,25٫48,274,182,309,127
Male,360,672,86,202,24٫08,288,169,289,120
Male,360,672,92,217,25٫76,285,178,317,139
Male,360,673,87,210,24٫36,281,182,343,161
Male,360,673,87,213,24٫36,279,171,297,126
Male,360,673,89,216,24٫92,281,182,336,154
Male,360,676,93,218,26٫04,287,186,295,109
Male,361,596,89,217,24٫92,267,171,311,140
Male,361,620,91,223,25٫48,256,177,311,134
Male,361,622,86,204,24٫08,271,165,284,119
Male,361,622,90,216,25٫2,267,180,322,142
Male,361,628,91,209,25٫48,269,167,305,138
Male,361,629,87,207,24٫36,277,170,310,140
Male,361,630,87,205,24٫36,271,174,318,144
Male,361,630,88,213,24٫64,278,174,304,130
Male,361,630,94,220,26٫32,286,170,312,142
Male,361,633,90,213,25٫2,277,176,305,129
Male,361,633,95,230,26٫6,274,180,328,148
Male,361,637,88,214,24٫64,269,175,312,137
Male,361,637,90,218,25٫2,277,184,327,143
Male,361,638,91,221,25٫48,278,185,306,121
Male,361,639,86,208,24٫08,272,169,307,138
Male,361,639,88,212,24٫64,264,183,317,134
Male,361,639,93,223,26٫04,271,180,325,145
Male,361,642,88,217,24٫64,275,184,318,134
Male,361,642,90,214,25٫2,266,182,340,158
Male,361,642,93,223,26٫04,272,186,346,160
Male,361,643,87,213,24٫36,262,170,316,146
Male,361,643,89,218,24٫92,273,182,320,138
Male,361,643,93,217,26٫04,275,182,313,131
Male,361,644,90,223,25٫2,272,177,328,151
Male,361,646,82,203,22٫96,275,175,333,158
Male,361,647,91,217,25٫48,278,172,301,129
Male,361,650,90,216,25٫2,281,182,307,125
Male,361,651,86,205,24٫08,284,169,319,150
Male,361,651,88,212,24٫64,278,182,339,157
Male,361,652,88,214,24٫64,269,179,293,114
Male,361,652,90,214,25٫2,274,183,292,109
Male,361,653,88,218,24٫64,274,186,339,153
Male,361,654,91,219,25٫48,271,175,326,151
Male,361,654,92,221,25٫76,273,182,314,132
Male,361,655,88,223,24٫64,273,188,320,132
Male,361,655,90,215,25٫2,274,178,322,144
Male,361,655,96,225,26٫88,273,191,315,124
Male,361,656,92,223,25٫76,283,180,317,137
Male,361,657,86,207,24٫08,285,169,301,132
Male,361,659,86,204,24٫08,269,172,304,132
Male,361,659,88,215,24٫64,279,181,327,146
Male,361,659,90,212,25٫2,285,172,328,156
Male,361,659,92,213,25٫76,292,174,310,136
Male,361,660,88,212,24٫64,275,175,316,141
Male,361,664,87,203,24٫36,287,167,291,124
Male,361,664,88,209,24٫64,283,173,312,139
Male,361,665,91,222,25٫48,282,182,319,137
Male,361,670,89,214,24٫92,287,174,335,161
Male,361,674,87,217,24٫36,277,173,288,115
Male,361,674,90,217,25٫2,285,179,310,131
Male,361,675,89,213,24٫92,280,176,317,141
Male,361,682,87,209,24٫36,284,173,289,116
Male,361,682,87,212,24٫36,285,177,312,135
Male,362,621,83,202,23٫24,273,170,292,122
Male,362,621,84,205,23٫52,271,173,284,111
Male,362,621,92,217,25٫76,269,186,329,143
Male,362,623,88,217,24٫64,271,178,324,146
Male,362,625,85,204,23٫8,263,175,298,123
Male,362,625,88,215,24٫64,277,180,327,147
Male,362,625,91,229,25٫48,267,177,321,144
Male,362,627,90,212,25٫2,271,183,317,134
Male,362,630,91,220,25٫48,269,188,321,133
Male,362,633,86,214,24٫08,265,169,299,130
Male,362,635,89,220,24٫92,273,183,328,145
Male,362,637,84,200,23٫52,281,173,307,134
Male,362,637,88,213,24٫64,273,174,305,131
Male,362,638,90,220,25٫2,276,183,334,151
Male,362,638,91,217,25٫48,268,183,322,139
Male,362,639,92,222,25٫76,272,181,338,157
Male,362,640,85,203,23٫8,267,184,300,116
Male,362,641,87,210,24٫36,268,170,297,127
Male,362,642,89,214,24٫92,279,178,332,154
Male,362,644,85,209,23٫8,282,180,320,140
Male,362,644,92,216,25٫76,273,185,312,127
Male,362,645,87,212,24٫36,273,176,316,140
Male,362,645,87,213,24٫36,277,174,317,143
Male,362,646,84,210,23٫52,276,181,321,140
Male,362,646,90,219,25٫2,269,190,305,115
Male,362,646,92,215,25٫76,269,180,326,146
Male,362,647,86,213,24٫08,274,172,323,151
Male,362,650,86,204,24٫08,289,170,319,149
Male,362,650,93,220,26٫04,270,184,330,146
Male,362,650,95,230,26٫6,270,188,346,158
Male,362,652,90,218,25٫2,278,173,314,141
Male,362,654,83,208,23٫24,291,170,291,121
Male,362,654,92,223,25٫76,274,183,315,132
Male,362,654,93,220,26٫04,275,184,330,146
Male,362,655,84,206,23٫52,279,177,314,137
Male,362,656,91,208,25٫48,281,170,316,146
Male,362,657,88,216,24٫64,276,172,303,131
Male,362,657,90,221,25٫2,284,186,345,159
Male,362,657,92,217,25٫76,277,177,299,122
Male,362,658,85,202,23٫8,270,167,316,149
Male,362,658,91,218,25٫48,278,180,303,123
Male,362,658,94,222,26٫32,282,177,306,129
Male,362,660,87,212,24٫36,281,177,298,121
Male,362,660,91,221,25٫48,286,177,331,154
Male,362,665,90,211,25٫2,282,175,301,126
Male,362,665,92,224,25٫76,281,188,329,141
Male,362,668,88,208,24٫64,289,179,287,108
Male,362,672,92,217,25٫76,285,176,288,112
Male,362,673,92,223,25٫76,286,190,341,151
Male,362,683,92,220,25٫76,282,185,321,136
Male,363,615,88,213,24٫64,273,182,325,143
Male,363,620,89,216,24٫92,266,179,321,142
Male,363,626,93,224,26٫04,271,182,332,150
Male,363,632,84,208,23٫52,278,173,312,139
Male,363,632,90,214,25٫2,261,185,307,122
Male,363,637,87,216,24٫36,283,173,315,142
Male,363,640,93,223,26٫04,273,186,328,142
Male,363,644,84,210,23٫52,274,169,318,149
Male,363,645,91,221,25٫48,268,180,330,150
Male,363,646,95,227,26٫6,271,186,329,143
Male,363,647,87,212,24٫36,272,177,299,122
Male,363,649,91,217,25٫48,276,186,316,130
Male,363,651,86,207,24٫08,280,172,293,121
Male,363,651,87,206,24٫36,277,184,345,161
Male,363,651,90,214,25٫2,277,182,315,133
Male,363,654,89,212,24٫92,283,178,310,132
Male,363,655,87,212,24٫36,271,178,317,139
Male,363,656,85,207,23٫8,283,169,312,143
Male,363,656,93,220,26٫04,278,185,294,109
Male,363,657,89,216,24٫92,277,178,291,113
Male,363,657,94,226,26٫32,269,188,337,149
Male,363,659,89,209,24٫92,268,176,332,156
Male,363,660,90,221,25٫2,276,182,339,157
Male,363,661,94,223,26٫32,279,184,343,159
Male,363,662,89,223,24٫92,285,182,327,145
Male,363,662,96,230,26٫88,282,183,324,141
Male,363,663,91,215,25٫48,265,183,308,125
Male,363,663,92,217,25٫76,278,175,324,149
Male,363,663,94,227,26٫32,280,185,325,140
Male,363,664,90,215,25٫2,278,176,315,139
Male,363,665,94,227,26٫32,275,189,321,132
Male,363,666,90,214,25٫2,294,172,283,111
Male,363,666,94,221,26٫32,278,172,305,133
Male,363,667,91,216,25٫48,276,182,335,153
Male,363,668,94,226,26٫32,281,187,330,143
Male,363,671,84,206,23٫52,279,168,285,117
Male,363,672,92,218,25٫76,290,178,309,131
Male,363,679,94,223,26٫32,294,174,305,131
Male,364,618,89,210,24٫92,263,177,331,154
Male,364,622,87,213,24٫36,266,184,342,158
Male,364,628,93,222,26٫04,264,187,340,153
Male,364,631,90,221,25٫2,277,182,312,130
Male,364,634,84,200,23٫52,275,162,282,120
Male,364,634,92,217,25٫76,278,178,300,122
Male,364,634,92,218,25٫76,279,175,317,142
Male,364,636,86,206,24٫08,277,174,286,112
Male,364,636,93,226,26٫04,280,179,322,143
Male,364,637,88,208,24٫64,277,164,288,124
Male,364,638,89,215,24٫92,285,174,306,132
Male,364,638,91,218,25٫48,277,177,299,122
Male,364,638,93,220,26٫04,275,181,317,136
Male,364,639,87,210,24٫36,271,178,315,137
Male,364,639,94,226,26٫32,273,186,322,136
Male,364,639,94,230,26٫32,276,185,334,149
Male,364,642,87,210,24٫36,283,171,312,141
Male,364,642,92,219,25٫76,277,182,338,156
Male,364,646,82,196,22٫96,278,178,307,129
Male,364,646,92,220,25٫76,268,185,324,139
Male,364,648,83,207,23٫24,279,171,316,145
Male,364,648,84,203,23٫52,273,164,314,150
Male,364,648,90,223,25٫2,278,188,316,128
Male,364,648,92,217,25٫76,279,174,298,124
Male,364,651,90,215,25٫2,284,177,328,151
Male,364,653,88,215,24٫64,287,180,334,154
Male,364,653,89,214,24٫92,270,180,338,158
Male,364,654,84,207,23٫52,280,175,288,113
Male,364,654,93,217,26٫04,270,182,299,117
Male,364,655,86,208,24٫08,278,166,287,121
Male,364,655,86,210,24٫08,279,180,331,151
Male,364,657,89,216,24٫92,276,183,336,153
Male,364,657,89,216,24٫92,287,184,330,146
Male,364,657,92,220,25٫76,282,186,303,117
Male,364,658,85,201,23٫8,278,166,280,114
Male,364,659,88,217,24٫64,274,190,334,144
Male,364,659,89,216,24٫92,283,184,320,136
Male,364,660,89,212,24٫92,273,178,321,143
Male,364,660,90,217,25٫2,273,184,311,127
Male,364,661,94,221,26٫32,287,176,304,128
Male,364,662,85,202,23٫8,288,180,306,126
Male,364,662,88,220,24٫64,277,173,318,145
Male,364,662,91,220,25٫48,288,179,336,157
Male,364,663,89,215,24٫92,281,186,317,131
Male,364,663,93,222,26٫04,286,186,326,140
Male,364,663,93,225,26٫04,283,180,336,156
Male,364,664,91,223,25٫48,283,178,310,132
Male,364,667,95,227,26٫6,276,184,318,134
Male,364,668,91,220,25٫48,284,185,310,125
Male,364,669,90,212,25٫2,283,183,317,134
Male,364,671,93,223,26٫04,282,185,320,135
Male,364,675,90,215,25٫2,288,177,314,137
Male,364,681,90,209,25٫2,288,170,306,136
Male,365,606,92,222,25٫76,264,185,343,158
Male,365,615,95,229,26٫6,273,180,324,144
Male,365,634,85,210,23٫8,282,171,317,146
Male,365,634,88,209,24٫64,273,178,340,162
Male,365,635,88,223,24٫64,266,188,320,132
Male,365,637,90,210,25٫2,276,182,301,119
Male,365,638,90,216,25٫2,270,175,330,155
Male,365,639,85,211,23٫8,266,178,298,120
Male,365,641,89,223,24٫92,266,189,317,128
Male,365,642,89,216,24٫92,274,183,330,147
Male,365,643,93,220,26٫04,275,188,314,126
Male,365,644,88,213,24٫64,276,183,324,141
Male,365,644,90,220,25٫2,275,178,315,137
Male,365,646,85,218,23٫8,272,173,315,142
Male,365,646,93,220,26٫04,270,189,318,129
Male,365,647,86,204,24٫08,268,179,288,109
Male,365,647,90,210,25٫2,269,171,288,117
Male,365,648,88,210,24٫64,268,177,317,140
Male,365,649,83,202,23٫24,292,162,289,127
Male,365,652,85,207,23٫8,282,174,328,154
Male,365,652,95,228,26٫6,274,190,323,133
Male,365,654,83,198,23٫24,278,168,294,126
Male,365,657,88,213,24٫64,269,174,295,121
Male,365,657,88,217,24٫64,271,182,329,147
Male,365,658,91,215,25٫48,283,177,311,134
Male,365,659,85,212,23٫8,281,177,309,132
Male,365,660,88,218,24٫64,278,175,306,131
Male,365,661,90,213,25٫2,287,178,300,122
Male,365,662,87,210,24٫36,284,182,340,158
Male,365,662,88,216,24٫64,280,188,322,134
Male,365,662,93,217,26٫04,276,180,318,138
Male,365,663,88,216,24٫64,284,185,305,120
Male,365,663,89,220,24٫92,285,178,304,126
Male,365,663,93,227,26٫04,281,187,304,117
Male,365,664,88,210,24٫64,283,174,297,123
Male,365,664,89,215,24٫92,282,177,290,113
Male,365,667,91,221,25٫48,284,170,327,157
Male,365,667,93,220,26٫04,277,187,338,151
Male,365,668,84,211,23٫52,281,171,324,153
Male,365,669,87,206,24٫36,279,175,289,114
Male,365,670,91,221,25٫48,279,176,306,130
Male,365,673,94,223,26٫32,295,181,306,125
Male,365,674,94,219,26٫32,287,183,312,129
Male,365,677,86,208,24٫08,287,176,308,132
Male,365,678,87,199,24٫36,290,176,326,150
Male,365,678,90,220,25٫2,288,185,329,144
Male,365,679,88,211,24٫64,285,185,332,147
Male,365,681,84,207,23٫52,286,172,307,135
Male,365,684,92,222,25٫76,294,180,317,137
Male,366,631,88,211,24٫64,275,174,296,122
Male,366,632,87,205,24٫36,275,178,287,109
Male,366,635,92,223,25٫76,275,183,322,139
Male,366,638,88,217,24٫64,264,181,337,156
Male,366,639,86,205,24٫08,280,168,296,128
Male,366,639,95,226,26٫6,269,188,328,140
Male,366,640,84,210,23٫52,279,178,307,129
Male,366,641,90,217,25٫2,279,181,330,149
Male,366,642,81,204,22٫68,276,173,313,140
Male,366,643,94,229,26٫32,278,182,341,159
Male,366,646,85,207,23٫8,275,171,315,144
Male,366,648,88,219,24٫64,283,178,337,159
Male,366,648,91,215,25٫48,270,180,324,144
Male,366,649,85,204,23٫8,279,166,276,110
Male,366,650,90,217,25٫2,289,188,343,155
Male,366,650,91,225,25٫48,272,186,313,127
Male,366,651,91,221,25٫48,269,179,304,125
Male,366,651,94,228,26٫32,279,189,329,140
Male,366,652,82,206,22٫96,282,167,297,130
Male,366,652,91,217,25٫48,271,175,325,150
Male,366,652,95,230,26٫6,278,187,324,137
Male,366,654,90,218,25٫2,268,180,314,134
Male,366,655,95,223,26٫6,283,179,296,117
Male,366,656,88,212,24٫64,278,176,295,119
Male,366,657,85,206,23٫8,287,172,329,157
Male,366,657,88,210,24٫64,284,179,333,154
Male,366,658,88,210,24٫64,282,179,295,116
Male,366,660,90,212,25٫2,277,173,300,127
Male,366,661,86,207,24٫08,278,177,297,120
Male,366,661,93,217,26٫04,281,185,341,156
Male,366,662,88,213,24٫64,278,185,330,145
Male,366,662,89,208,24٫92,279,185,308,123
Male,366,663,89,209,24٫92,279,171,310,139
Male,366,666,90,220,25٫2,279,182,310,128
Male,366,668,89,213,24٫92,277,178,307,129
Male,366,670,88,221,24٫64,282,182,303,121
Male,366,670,90,214,25٫2,286,170,311,141
Male,366,671,91,220,25٫48,292,172,310,138
Male,366,674,90,221,25٫2,295,179,297,118
Male,366,674,93,220,26٫04,284,185,309,124
Male,366,677,91,220,25٫48,280,179,330,151
Male,366,684,89,210,24٫92,295,180,312,132
Male,367,633,91,214,25٫48,276,176,333,157
Male,367,635,88,217,24٫64,272,184,338,154
Male,367,640,92,225,25٫76,282,187,313,126
Male,367,641,91,226,25٫48,267,188,337,149
Male,367,642,96,228,26٫88,291,176,304,128
Male,367,644,93,220,26٫04,279,188,339,151
Male,367,649,90,215,25٫2,279,171,309,138
Male,367,649,94,223,26٫32,284,184,331,147
Male,367,650,86,207,24٫08,285,173,312,139
Male,367,651,84,208,23٫52,278,179,299,120
Male,367,652,89,212,24٫92,278,182,318,136
Male,367,655,90,215,25٫2,280,188,325,137
Male,367,656,94,222,26٫32,282,180,295,115
Male,367,657,90,227,25٫2,280,187,337,150
Male,367,658,90,216,25٫2,279,189,325,136
Male,367,659,88,208,24٫64,291,170,281,111
Male,367,660,88,217,24٫64,280,185,332,147
Male,367,660,93,221,26٫04,271,188,329,141
Male,367,664,88,207,24٫64,275,178,307,129
Male,367,665,89,214,24٫92,275,178,329,151
Male,367,666,84,211,23٫52,287,180,334,154
Male,367,666,88,212,24٫64,284,182,316,134
Male,367,666,91,222,25٫48,284,179,308,129
Male,367,667,96,224,26٫88,283,185,319,134
Male,367,668,87,207,24٫36,282,171,293,122
Male,367,669,87,207,24٫36,289,169,300,131
Male,367,669,88,212,24٫64,288,171,302,131
Male,367,670,95,226,26٫6,283,181,316,135
Male,367,673,90,216,25٫2,282,181,314,133
Male,367,673,91,213,25٫48,279,181,317,136
Male,367,674,88,211,24٫64,287,180,320,140
Male,367,675,86,205,24٫08,290,175,318,143
Male,367,675,93,221,26٫04,282,187,328,141
Male,367,677,92,219,25٫76,281,186,320,134
Male,367,680,85,208,23٫8,287,171,286,115
Male,367,682,87,208,24٫36,292,183,317,134
Male,368,625,87,203,24٫36,282,168,311,143
Male,368,626,90,220,25٫2,273,177,337,160
Male,368,629,91,213,25٫48,273,178,305,127
Male,368,631,92,218,25٫76,284,175,325,150
Male,368,636,88,208,24٫64,277,172,319,147
Male,368,639,92,221,25٫76,268,187,346,159
Male,368,640,89,218,24٫92,277,186,323,137
Male,368,643,90,213,25٫2,271,178,310,132
Male,368,643,90,222,25٫2,288,180,313,133
Male,368,646,90,217,25٫2,280,176,305,129
Male,368,648,94,222,26٫32,275,185,327,142
Male,368,649,90,224,25٫2,266,172,292,120
Male,368,650,93,225,26٫04,281,189,330,141
Male,368,652,85,200,23٫8,286,171,291,120
Male,368,652,92,222,25٫76,273,186,344,158
Male,368,653,94,224,26٫32,268,176,302,126
Male,368,654,89,215,24٫92,284,179,337,158
Male,368,654,90,216,25٫2,280,170,327,157
Male,368,654,92,217,25٫76,274,189,337,148
Male,368,655,88,206,24٫64,278,173,297,124
Male,368,657,85,206,23٫8,282,171,286,115
Male,368,659,86,212,24٫08,290,176,310,134
Male,368,660,85,206,23٫8,291,181,336,155
Male,368,660,93,220,26٫04,269,183,321,138
Male,368,661,88,217,24٫64,268,190,314,124
Male,368,661,91,220,25٫48,294,186,318,132
Male,368,661,92,223,25٫76,284,188,303,115
Male,368,662,89,217,24٫92,268,176,315,139
Male,368,663,94,222,26٫32,272,187,345,158
Male,368,664,90,221,25٫2,285,178,320,142
Male,368,666,88,205,24٫64,281,175,314,139
Male,368,668,89,213,24٫92,274,178,303,125
Male,368,669,83,201,23٫24,283,174,311,137
Male,368,670,89,217,24٫92,288,178,306,128
Male,368,672,92,224,25٫76,289,188,306,118
Male,368,674,88,221,24٫64,285,181,305,124
Male,368,674,93,223,26٫04,295,177,317,140
Male,368,674,94,224,26٫32,284,189,323,134
Male,368,675,90,216,25٫2,282,179,322,143
Male,368,675,93,218,26٫04,274,177,328,151
Male,368,678,84,207,23٫52,284,176,334,158
Male,368,682,90,220,25٫2,287,187,329,142
Male,368,682,92,225,25٫76,287,190,340,150
Male,368,684,91,216,25٫48,288,175,311,136
Male,369,635,86,211,24٫08,276,183,321,138
Male,369,648,86,208,24٫08,280,173,320,147
Male,369,648,92,222,25٫76,277,186,302,116
Male,369,648,93,227,26٫04,287,176,316,140
Male,369,649,93,225,26٫04,272,181,304,123
Male,369,650,90,213,25٫2,286,174,306,132
Male,369,651,88,222,24٫64,284,177,324,147
Male,369,653,83,203,23٫24,287,171,305,134
Male,369,655,92,222,25٫76,280,175,315,140
Male,369,655,95,223,26٫6,274,183,327,144
Male,369,656,93,224,26٫04,281,185,344,159
Male,369,662,86,206,24٫08,283,173,292,119
Male,369,662,93,215,26٫04,281,181,323,142
Male,369,662,94,223,26٫32,281,184,313,129
Male,369,665,89,214,24٫92,294,172,296,124
Male,369,666,85,207,23٫8,281,168,295,127
Male,369,666,95,230,26٫6,284,189,314,125
Male,369,670,94,220,26٫32,289,178,315,137
Male,369,676,94,223,26٫32,288,181,340,159
Male,369,677,94,222,26٫32,288,179,319,140
Male,369,678,92,226,25٫76,289,186,327,141
Male,369,678,93,223,26٫04,284,190,333,143
Male,370,626,90,222,25٫2,268,190,332,142
Male,370,626,90,222,25٫2,285,178,328,150
Male,370,636,88,215,24٫64,275,170,292,122
Male,370,640,87,203,24٫36,282,177,323,146
Male,370,645,90,221,25٫2,282,187,317,130
Male,370,646,93,225,26٫04,282,185,334,149
Male,370,650,94,221,26٫32,286,176,320,144
Male,370,652,91,218,25٫48,290,165,294,129
Male,370,653,91,224,25٫48,274,188,323,135
Male,370,655,87,209,24٫36,272,172,305,133
Male,370,655,93,217,26٫04,283,177,311,134
Male,370,656,84,202,23٫52,280,178,290,112
Male,370,656,88,213,24٫64,281,180,292,112
Male,370,661,87,217,24٫36,287,178,316,138
Male,370,661,93,226,26٫04,286,191,311,120
Male,370,661,93,227,26٫04,281,177,303,126
Male,370,662,92,225,25٫76,293,177,329,152
Male,370,663,89,206,24٫92,292,171,279,108
Male,370,663,92,220,25٫76,275,181,323,142
Male,370,664,93,228,26٫04,271,181,334,153
Male,370,671,86,203,24٫08,294,175,306,131
Male,370,671,96,229,26٫88,281,182,331,149
Male,370,672,87,212,24٫36,280,166,301,135
Male,370,676,93,221,26٫04,290,176,306,130
Male,370,677,88,214,24٫64,291,172,302,130
Male,370,682,87,219,24٫36,290,180,333,153
Male,370,683,90,210,25٫2,285,175,330,155
Male,371,625,87,208,24٫36,290,171,314,143
Male,371,636,91,220,25٫48,275,185,326,141
Male,371,639,87,214,24٫36,273,175,317,142
Male,371,641,91,220,25٫48,273,180,325,145
Male,371,642,94,223,26٫32,274,189,335,146
Male,371,644,85,207,23٫8,275,175,303,128
Male,371,650,87,207,24٫36,279,175,291,116
Male,371,651,93,225,26٫04,284,188,346,158
Male,371,652,92,222,25٫76,279,188,337,149
Male,371,655,92,230,25٫76,275,186,318,132
Male,371,661,88,213,24٫64,276,176,317,141
Male,371,662,87,205,24٫36,290,175,314,139
Male,371,666,93,218,26٫04,278,174,307,133
Male,371,668,90,216,25٫2,284,181,304,123
Male,371,669,90,216,25٫2,291,176,331,155
Male,371,670,96,224,26٫88,286,181,320,139
Male,371,674,90,215,25٫2,287,184,309,125
Male,371,678,94,223,26٫32,281,187,337,150
Male,371,679,92,222,25٫76,295,175,316,141
Male,371,681,94,225,26٫32,283,183,342,159
Male,371,682,90,218,25٫2,283,185,311,126
Male,371,683,86,205,24٫08,288,173,281,108
Male,371,685,95,223,26٫6,290,181,330,149
Male,372,632,88,218,24٫64,265,174,303,129
Male,372,636,89,215,24٫92,281,174,311,137
Male,372,647,95,224,26٫6,266,184,323,139
Male,372,653,86,216,24٫08,273,181,310,129
Male,372,658,95,224,26٫6,292,184,318,134
Male,372,660,86,206,24٫08,286,173,288,115
Male,372,661,88,213,24٫64,285,184,297,113
Male,372,661,91,217,25٫48,291,190,338,148
Male,372,664,87,206,24٫36,292,165,292,127
Male,372,664,96,218,26٫88,291,185,323,138
Male,372,665,88,215,24٫64,284,187,322,135
Male,372,669,90,214,25٫2,288,183,309,126
Male,372,673,88,213,24٫64,289,175,303,128
Male,372,674,90,211,25٫2,282,179,296,117
Male,372,678,94,230,26٫32,289,188,310,122
Male,372,679,92,218,25٫76,289,189,337,148
Male,372,682,93,214,26٫04,289,179,293,114
Male,372,685,94,221,26٫32,290,182,291,109
Male,373,633,88,212,24٫64,277,179,341,162
Male,373,636,86,204,24٫08,279,175,299,124
Male,373,648,92,223,25٫76,287,184,318,134
Male,373,653,89,224,24٫92,282,186,342,156
Male,373,654,88,212,24٫64,279,189,332,143
Male,373,659,91,216,25٫48,288,168,295,127
Male,373,664,89,216,24٫92,282,185,296,111
Male,373,666,89,212,24٫92,282,181,296,115
Male,373,666,92,216,25٫76,285,177,297,120
Male,373,667,89,213,24٫92,281,179,307,128
Male,373,667,94,227,26٫32,283,189,345,156
Male,373,670,83,197,23٫24,283,168,301,133
Male,373,670,93,222,26٫04,275,187,324,137
Male,373,679,89,210,24٫92,289,171,302,131
Male,373,679,94,222,26٫32,289,180,303,123
Male,374,648,88,216,24٫64,285,173,318,145
Male,374,648,90,220,25٫2,286,185,330,145
Male,374,651,89,222,24٫92,268,182,330,148
Male,374,653,95,225,26٫6,293,174,308,134
Male,374,654,91,217,25٫48,287,175,318,143
Male,374,658,91,215,25٫48,282,184,306,122
Male,374,659,88,215,24٫64,295,176,320,144
Male,374,659,90,220,25٫2,279,175,318,143
Male,374,662,91,218,25٫48,281,178,309,131
Male,374,662,91,221,25٫48,290,176,323,147
Male,374,663,89,212,24٫92,287,167,313,146
Male,374,664,86,214,24٫08,284,174,327,153
Male,374,664,94,228,26٫32,282,185,318,133
Male,374,666,84,204,23٫52,292,178,317,139
Male,374,666,85,202,23٫8,295,174,292,118
Male,374,666,94,222,26٫32,290,181,311,130
Male,374,669,91,218,25٫48,290,174,311,137
Male,374,672,89,213,24٫92,286,181,328,147
Male,374,679,89,213,24٫92,288,176,290,114
Male,374,682,90,212,25٫2,294,168,302,134
Male,374,682,93,221,26٫04,290,185,330,145
Male,374,684,92,219,25٫76,285,176,286,110
Male,375,653,84,207,23٫52,292,167,297,130
Male,375,656,84,204,23٫52,277,168,292,124
Male,375,656,93,222,26٫04,292,182,320,138
Male,375,658,88,214,24٫64,282,185,319,134
Male,375,666,92,222,25٫76,284,190,311,121
Male,375,669,90,220,25٫2,291,181,311,130
Male,375,676,91,218,25٫48,291,175,302,127
Male,375,676,93,219,26٫04,286,180,305,125
Male,375,677,94,223,26٫32,288,185,321,136
Male,375,679,91,211,25٫48,282,182,305,123
Male,375,682,87,207,24٫36,284,171,288,117
Male,376,636,93,223,26٫04,276,183,324,141
Male,376,642,90,216,25٫2,277,175,306,131
Male,376,654,92,217,25٫76,272,181,312,131
Male,376,656,88,220,24٫64,274,187,338,151
Male,376,661,91,220,25٫48,289,185,345,160
Male,376,663,84,198,23٫52,278,170,281,111
Male,376,663,92,222,25٫76,282,188,329,141
Male,376,670,92,223,25٫76,287,185,315,130
Male,376,672,94,221,26٫32,272,182,303,121
Male,376,672,96,228,26٫88,292,185,318,133
Male,376,674,91,213,25٫48,292,180,320,140
Male,376,676,91,220,25٫48,289,189,328,139
Male,376,678,93,222,26٫04,290,181,330,149
Male,376,680,87,210,24٫36,289,172,334,162
Male,376,680,91,223,25٫48,284,190,347,157
Male,376,681,94,222,26٫32,295,187,320,133
Male,377,651,91,214,25٫48,285,179,309,130
Male,377,652,89,215,24٫92,294,191,310,119
Male,377,656,90,220,25٫2,292,170,320,150
Male,377,657,88,217,24٫64,283,178,327,149
Male,377,657,96,226,26٫88,277,184,339,155
Male,377,660,90,214,25٫2,283,185,321,136
Male,377,661,94,227,26٫32,282,191,328,137
Male,377,664,94,225,26٫32,284,183,312,129
Male,377,671,88,214,24٫64,288,184,312,128
Male,377,676,93,220,26٫04,277,172,320,148
Male,377,681,95,223,26٫6,295,182,317,135
Male,377,682,88,210,24٫64,290,186,317,131
Male,378,640,88,210,24٫64,284,173,306,133
Male,378,657,86,217,24٫08,288,167,293,126
Male,378,667,92,224,25٫76,290,179,313,134
Male,378,669,85,206,23٫8,289,173,311,138
Male,378,669,89,216,24٫92,290,184,313,129
Male,378,670,91,219,25٫48,287,180,315,135
Male,378,678,83,204,23٫24,288,170,317,147
Male,378,681,83,202,23٫24,292,171,300,129
Male,379,651,87,206,24٫36,279,179,308,129
Male,379,655,85,202,23٫8,289,177,333,156
Male,379,655,86,204,24٫08,290,176,294,118
Male,379,666,92,220,25٫76,289,189,325,136
Male,379,681,91,217,25٫48,295,178,338,160